,tconst,movie,runtime_minutes,genres,average_rating,release_date,production_budget,domestic_gross,worldwide_gross,Collections,Profit,release_year,Month,release_month,release_season,release_quarter
2911,tt4154756,avengersinfinitywar,149,"Action,Adventure,Sci-Fi",8.5,2018-04-27,300000000,678815482,2048134200,2726949682,2426949682,2018,April,4,spring,Q2
8,tt0369610,jurassicworld,124,"Action,Adventure,Sci-Fi",7.0,2015-06-12,215000000,652270625,1648854864,2301125489,2086125489,2015,June,6,summer,Q2
123,tt0848228,theavengers,143,"Action,Adventure,Sci-Fi",8.1,2012-05-04,225000000,623279547,1517935897,2141215444,1916215444,2012,May,5,spring,Q2
1589,tt1825683,blackpanther,134,"Action,Adventure,Sci-Fi",7.3,2018-02-16,200000000,700059566,1348258224,2048317790,1848317790,2018,February,2,winter/holiday,Q1
2796,tt3606756,incredibles2,118,"Action,Adventure,Animation",7.7,2018-06-15,200000000,608581744,1242520711,1851102455,1651102455,2018,June,6,summer,Q2
2505,tt2771200,beautyandthebeast,129,"Family,Fantasy,Musical",7.2,2017-03-17,160000000,504014165,1259199706,1763213871,1603213871,2017,March,3,spring,Q1
3035,tt4881806,jurassicworldfallenkingdom,128,"Action,Adventure,Sci-Fi",6.2,2018-06-22,170000000,417719760,1305772799,1723492559,1553492559,2018,June,6,summer,Q2
2338,tt2395427,avengersageofultron,141,"Action,Adventure,Sci-Fi",7.3,2015-05-01,330600000,459005868,1403013963,1862019831,1531419831,2015,May,5,spring,Q2
588,tt1323045,frozen,93,"Adventure,Drama,Sport",6.2,2013-11-22,150000000,400738009,1272469910,1673207919,1523207919,2013,November,11,Fall,Q4
2235,tt2293640,minions,91,"Adventure,Animation,Comedy",6.4,2015-07-10,74000000,336045770,1160336173,1496381943,1422381943,2015,July,7,summer,Q3
884,tt1477834,aquaman,143,"Action,Adventure,Fantasy",7.1,2018-12-21,160000000,335061807,1146894640,1481956447,1321956447,2018,December,12,winter/holiday,Q4
2225,tt2277860,findingdory,97,"Adventure,Animation,Comedy",7.3,2016-06-17,200000000,486295561,1021215193,1507510754,1307510754,2016,June,6,summer,Q2
2762,tt3498820,captainamericacivilwar,147,"Action,Adventure,Sci-Fi",7.8,2016-05-06,250000000,408084349,1140069413,1548153762,1298153762,2016,May,5,spring,Q2
24,tt0435761,toystory3,103,"Adventure,Animation,Comedy",8.3,2010-06-18,200000000,415004880,1068879522,1483884402,1283884402,2010,June,6,summer,Q2
689,tt1399103,transformersdarkofthemoon,154,"Action,Adventure,Sci-Fi",6.2,2011-06-29,195000000,352390543,1123790543,1476181086,1281181086,2011,June,6,summer,Q2
2230,tt2283362,jumanjiwelcometothejungle,119,"Action,Adventure,Comedy",7.0,2017-12-20,90000000,404508916,964496193,1369005109,1279005109,2017,December,12,winter/holiday,Q4
1337,tt1690953,despicableme2,98,"Adventure,Animation,Comedy",7.4,2013-07-03,76000000,368065385,975216835,1343282220,1267282220,2013,July,7,summer,Q3
617,tt1345836,thedarkknightrises,164,"Action,Thriller",8.4,2012-07-20,275000000,448139099,1084439099,1532578198,1257578198,2012,July,7,summer,Q3
2754,tt3469046,despicableme3,89,"Adventure,Animation,Comedy",6.3,2017-06-30,75000000,264624300,1034727750,1299352050,1224352050,2017,June,6,summer,Q2
260,tt1074638,skyfall,143,"Action,Adventure,Thriller",7.8,2012-11-08,200000000,304360277,1110526981,1414887258,1214887258,2012,November,11,Fall,Q4
2561,tt2948356,zootopia,108,"Adventure,Animation,Comedy",8.0,2016-03-04,150000000,341268248,1019429616,1360697864,1210697864,2016,March,3,spring,Q1
2987,tt4630562,thefateofthefurious,136,"Action,Crime,Thriller",6.7,2017-04-14,250000000,225764765,1234846267,1460611032,1210611032,2017,April,4,spring,Q2
2490,tt2709768,thesecretlifeofpets,87,"Adventure,Animation,Comedy",6.5,2016-07-08,75000000,368384330,886750534,1255134864,1180134864,2016,July,7,summer,Q3
210,tt1014759,aliceinwonderland,108,"Adventure,Family,Fantasy",6.5,2010-03-05,200000000,334191110,1025491110,1359682220,1159682220,2010,March,3,spring,Q1
1768,tt1951264,thehungergamescatchingfire,146,"Action,Adventure,Sci-Fi",7.5,2013-11-22,130000000,424668047,864868047,1289536094,1159536094,2013,November,11,Fall,Q4
2141,tt2226178,thejunglebook,64,Animation,7.0,2016-04-15,175000000,364001123,962854547,1326855670,1151855670,2016,April,4,spring,Q2
1928,tt2109248,transformersageofextinction,165,"Action,Adventure,Sci-Fi",5.7,2014-06-27,210000000,245439076,1104039076,1349478152,1139478152,2014,June,6,summer,Q2
755,tt1431045,deadpool,108,"Action,Adventure,Comedy",8.0,2016-02-12,58000000,363070709,801025593,1164096302,1106096302,2016,February,2,winter/holiday,Q1
32,tt0451279,wonderwoman,141,"Action,Adventure,Fantasy",7.5,2017-06-02,150000000,412563408,821133378,1233696786,1083696786,2017,June,6,summer,Q2
145,tt0903624,thehobbitanunexpectedjourney,169,"Adventure,Family,Fantasy",7.9,2012-12-14,250000000,303003568,1017003568,1320007136,1070007136,2012,December,12,winter/holiday,Q4
1409,tt1727824,bohemianrhapsody,134,"Biography,Drama,Music",8.0,2018-11-02,55000000,216303339,894985342,1111288681,1056288681,2018,November,11,Fall,Q4
2873,tt3896198,guardiansofthegalaxyvol2,136,"Action,Adventure,Comedy",7.7,2017-05-05,200000000,389813101,862316233,1252129334,1052129334,2017,May,5,spring,Q2
2184,tt2250912,spidermanhomecoming,133,"Action,Adventure,Sci-Fi",7.5,2017-07-07,175000000,334201140,880166350,1214367490,1039367490,2017,July,7,summer,Q3
1233,tt1640486,insideout,93,"Crime,Drama",4.6,2015-06-19,175000000,356461711,854235992,1210697703,1035697703,2015,June,6,summer,Q2
675,tt1392170,thehungergames,142,"Action,Adventure,Sci-Fi",7.2,2012-03-23,80000000,408010692,677923379,1085934071,1005934071,2012,March,3,spring,Q1
3085,tt5463162,deadpool2,119,"Action,Adventure,Comedy",7.8,2018-05-18,110000000,324591735,786680557,1111272292,1001272292,2018,May,5,spring,Q2
679,tt1396484,it,135,"Horror,Thriller",7.4,2017-09-08,35000000,327481748,697457969,1024939717,989939717,2017,September,9,Fall,Q3
1313,tt1673434,thetwilightsagabreakingdawnpart2,115,"Adventure,Drama,Fantasy",5.5,2012-11-16,136200000,292324737,829724737,1122049474,985849474,2012,November,11,Fall,Q4
2763,tt3501632,thorragnarok,130,"Action,Adventure,Comedy",7.9,2017-11-03,180000000,315058289,846980024,1162038313,982038313,2017,November,11,Fall,Q4
1769,tt1951265,thehungergamesmockingjaypart1,123,"Action,Adventure,Sci-Fi",6.6,2014-11-21,125000000,337135885,766575131,1103711016,978711016,2014,November,11,Fall,Q4
340,tt1170358,thehobbitthedesolationofsmaug,161,"Adventure,Fantasy",7.8,2013-12-13,250000000,258366855,960366855,1218733710,968733710,2013,December,12,winter/holiday,Q4
656,tt1375666,inception,148,"Action,Adventure,Sci-Fi",8.8,2010-07-16,160000000,292576195,835524642,1128100837,968100837,2010,July,7,summer,Q3
508,tt1270797,venom,112,"Action,Sci-Fi,Thriller",6.7,2018-10-05,116000000,213511408,853628605,1067140013,951140013,2018,October,10,Fall,Q4
2261,tt2310332,thehobbitthebattleofthefivearmies,144,"Adventure,Fantasy",7.4,2014-12-17,250000000,255119788,945577621,1200697409,950697409,2014,December,12,winter/holiday,Q4
2570,tt2975590,batmanvsupermandawnofjustice,151,"Action,Adventure,Fantasy",6.5,2016-03-25,250000000,330360194,867500281,1197860475,947860475,2016,March,3,spring,Q1
1307,tt1667889,iceagecontinentaldrift,88,"Adventure,Animation,Comedy",6.6,2012-07-13,95000000,161321843,879765137,1041086980,946086980,2012,July,7,summer,Q3
594,tt1325004,thetwilightsagaeclipse,124,"Adventure,Drama,Fantasy",5.0,2010-06-30,68000000,300531751,706102828,1006634579,938634579,2010,June,6,summer,Q2
1833,tt2015381,guardiansofthegalaxy,121,"Action,Adventure,Comedy",8.1,2014-08-01,170000000,333172112,770867516,1104039628,934039628,2014,August,8,summer,Q3
663,tt1386697,suicidesquad,123,"Action,Adventure,Fantasy",6.0,2016-08-05,175000000,325100054,746059887,1071159941,896159941,2016,August,8,summer,Q3
554,tt1298650,piratesofthecaribbeanonstrangertides,136,"Action,Adventure,Fantasy",6.6,2011-05-20,410600000,241063875,1045663875,1286727750,876127750,2011,May,5,spring,Q2
851,tt1454468,gravity,91,"Drama,Sci-Fi,Thriller",7.7,2013-10-04,110000000,274092705,693698673,967791378,857791378,2013,October,10,Fall,Q4
2628,tt3183660,fantasticbeastsandwheretofindthem,132,"Adventure,Family,Fantasy",7.3,2016-11-18,180000000,234037575,802402853,1036440428,856440428,2016,November,11,Fall,Q4
593,tt1324999,thetwilightsagabreakingdawnpart1,117,"Adventure,Drama,Fantasy",4.9,2011-11-18,127500000,281287133,689420051,970707184,843207184,2011,November,11,Fall,Q4
1975,tt2179136,americansniper,133,"Action,Biography,Drama",7.3,2014-12-25,58000000,350126372,547326372,897452744,839452744,2014,December,12,winter/holiday,Q4
2312,tt2380307,coco,105,"Adventure,Animation,Comedy",8.4,2017-11-22,175000000,209726015,798008101,1007734116,832734116,2017,November,11,Fall,Q4
143,tt0892791,shrekforeverafter,93,"Adventure,Animation,Comedy",6.3,2010-05-21,165000000,238736787,756244673,994981460,829981460,2010,May,5,spring,Q2
2755,tt3470600,sing,108,"Animation,Comedy,Family",7.1,2016-12-21,75000000,270329045,634454789,904783834,829783834,2016,December,12,winter/holiday,Q4
1105,tt1587310,maleficent,97,"Action,Adventure,Family",7.0,2014-05-30,180000000,241407328,758536735,999944063,819944063,2014,May,5,spring,Q2
525,tt1277953,madagascar3europesmostwanted,93,"Adventure,Animation,Comedy",6.8,2012-06-08,145000000,216391482,746921271,963312753,818312753,2012,June,6,summer,Q2
849,tt1453405,monstersuniversity,104,"Adventure,Animation,Comedy",7.3,2013-06-21,200000000,268488329,743588329,1012076658,812076658,2013,June,6,summer,Q2
1631,tt1843866,captainamericathewintersoldier,136,"Action,Adventure,Sci-Fi",7.8,2014-04-04,170000000,259746958,714401889,974148847,804148847,2014,April,4,spring,Q2
157,tt0948470,theamazingspiderman,136,"Action,Adventure,Sci-Fi",7.0,2012-07-03,220000000,262030663,757890267,1019920930,799920930,2012,July,7,summer,Q3
1700,tt1877832,xmendaysoffuturepast,132,"Action,Adventure,Sci-Fi",8.0,2014-05-23,200000000,233921534,747862775,981784309,781784309,2014,May,5,spring,Q2
2309,tt2379713,spectre,148,"Action,Adventure,Thriller",6.8,2015-11-06,300000000,200074175,879620923,1079695098,779695098,2015,November,11,Fall,Q4
2808,tt3659388,themartian,144,"Adventure,Drama,Sci-Fi",8.0,2015-10-02,108000000,228433663,655271443,883705106,775705106,2015,October,10,Fall,Q4
1770,tt1951266,thehungergamesmockingjaypart2,137,"Action,Adventure,Sci-Fi",6.6,2015-11-20,160000000,281723902,648986787,930710689,770710689,2015,November,11,Fall,Q4
424,tt1228705,ironman2,124,"Action,Adventure,Sci-Fi",7.0,2010-05-07,170000000,312433331,621156389,933589720,763589720,2010,May,5,spring,Q2
716,tt1411697,thehangoverpartii,102,"Comedy,Mystery",6.5,2011-05-26,80000000,254464305,586464305,840928610,760928610,2011,May,5,spring,Q2
1924,tt2103281,dawnoftheplanetoftheapes,130,"Action,Adventure,Drama",7.6,2014-07-11,170000000,208545589,710644566,919190155,749190155,2014,July,7,summer,Q3
385,tt1211837,doctorstrange,115,"Action,Adventure,Fantasy",7.5,2016-11-04,165000000,232641920,676404566,909046486,744046486,2016,November,11,Fall,Q4
2769,tt3521164,moana,107,"Adventure,Animation,Comedy",7.6,2016-11-23,150000000,248757044,637517365,886274409,736274409,2016,November,11,Fall,Q4
83,tt0770828,manofsteel,143,"Action,Adventure,Sci-Fi",7.1,2013-06-14,225000000,291045518,667999518,959045036,734045036,2013,June,6,summer,Q2
1536,tt1790809,piratesofthecaribbeandeadmentellnotales,129,"Action,Adventure,Fantasy",6.6,2017-05-26,230000000,172558876,788241137,960800013,730800013,2017,May,5,spring,Q2
592,tt1323594,despicableme,95,"Animation,Comedy,Family",7.7,2010-07-09,69000000,251513985,543464573,794978558,725978558,2010,July,7,summer,Q3
1229,tt1637725,ted,106,"Comedy,Fantasy",6.9,2012-06-29,50000000,218665740,556016627,774682367,724682367,2012,June,6,summer,Q2
1120,tt1596343,fastfive,130,"Action,Crime,Thriller",7.3,2011-04-29,125000000,210031325,630163454,840194779,715194779,2011,April,4,spring,Q2
888,tt1483010,logan,94,"Comedy,Drama,Family",6.2,2017-03-03,127000000,226277068,615461394,841738462,714738462,2017,March,3,spring,Q1
1692,tt1872181,theamazingspiderman2,142,"Action,Adventure,Sci-Fi",6.6,2014-05-02,200000000,202853933,708996336,911850269,711850269,2014,May,5,spring,Q2
3060,tt5095030,antmanandthewasp,118,"Action,Adventure,Comedy",7.1,2018-07-06,130000000,216648740,623144660,839793400,709793400,2018,July,7,summer,Q3
2169,tt2245084,bighero6,102,"Action,Adventure,Animation",7.8,2014-11-07,165000000,222527828,652127828,874655656,709655656,2014,November,11,Fall,Q4
1803,tt1981115,thorthedarkworld,112,"Action,Adventure,Fantasy",6.9,2013-11-08,150000000,206362140,644602516,850964656,700964656,2013,November,11,Fall,Q4
2269,tt2322441,fiftyshadesofgrey,125,"Drama,Romance,Thriller",4.1,2015-02-13,40000000,166167230,570998101,737165331,697165331,2015,February,2,winter/holiday,Q1
108,tt0816692,interstellar,169,"Adventure,Drama,Sci-Fi",8.6,2014-11-05,165000000,188017894,666379375,854397269,689397269,2014,November,11,Fall,Q4
555,tt1302011,kungfupanda2,90,"Action,Adventure,Animation",7.2,2011-05-26,150000000,165249063,664837547,830086610,680086610,2011,May,5,spring,Q2
911,tt1490017,thelegomovie,100,"Action,Adventure,Animation",7.8,2014-02-07,60000000,257784718,457729388,715514106,655514106,2014,February,2,winter/holiday,Q1
1250,tt1646971,howtotrainyourdragon2,102,"Action,Adventure,Animation",7.8,2014-06-13,145000000,177002924,614586270,791589194,646589194,2014,June,6,summer,Q2
1287,tt1661199,cinderella,105,"Drama,Family,Fantasy",6.9,2015-03-13,95000000,201151353,534551353,735702706,640702706,2015,March,3,spring,Q1
3070,tt5220122,hoteltransylvania3summervacation,97,"Adventure,Animation,Comedy",6.3,2018-07-13,65000000,167500092,527079962,694580054,629580054,2018,July,7,summer,Q3
39,tt0454876,lifeofpi,127,"Adventure,Drama,Fantasy",7.9,2012-11-21,120000000,124987022,620912003,745899025,625899025,2012,November,11,Fall,Q4
64,tt0481499,thecroods,98,"Action,Adventure,Animation",7.2,2013-03-22,135000000,187168425,573068425,760236850,625236850,2013,March,3,spring,Q1
712,tt1409024,meninblack3,106,"Action,Adventure,Comedy",6.8,2012-05-25,215000000,179020854,654213485,833234339,618234339,2012,May,5,spring,Q2
2248,tt2304901,sherlockholmes,77,Adventure,5.4,2009-12-25,90000000,209028679,498438212,707466891,617466891,2009,December,12,winter/holiday,Q4
972,tt1517451,astarisborn,136,"Drama,Music,Romance",7.8,2018-10-05,36000000,215288866,433449571,648738437,612738437,2018,October,10,Fall,Q4
2907,tt4123430,fantasticbeaststhecrimesofgrindelwald,134,"Adventure,Family,Fantasy",6.6,2018-11-16,200000000,159555901,652220086,811775987,611775987,2018,November,11,Fall,Q4
406,tt1217209,brave,93,"Adventure,Animation,Comedy",7.1,2012-06-22,185000000,237282182,554606532,791888714,606888714,2012,June,6,summer,Q2
965,tt1515091,sherlockholmesagameofshadows,129,"Action,Adventure,Crime",7.5,2011-12-16,125000000,186848418,535663443,722511861,597511861,2011,December,12,winter/holiday,Q4
49,tt0472181,thesmurfs,103,"Adventure,Animation,Comedy",5.5,2011-07-29,110000000,142614158,563749323,706363481,596363481,2011,July,7,summer,Q3
183,tt0974015,justiceleague,120,"Action,Adventure,Fantasy",6.5,2017-11-17,300000000,229024295,655945209,884969504,584969504,2017,November,11,Fall,Q4
1292,tt1663202,therevenant,156,"Action,Adventure,Biography",8.0,2015-12-25,135000000,183637894,532938302,716576196,581576196,2015,December,12,winter/holiday,Q4
31,tt0448694,pussinboots,90,"Action,Adventure,Animation",6.6,2011-10-28,130000000,149260504,554987477,704247981,574247981,2011,October,10,Fall,Q4
117,tt0831387,godzilla,123,"Action,Adventure,Sci-Fi",6.4,2014-05-16,160000000,200676069,529076069,729752138,569752138,2014,May,5,spring,Q2
59,tt0478970,antman,117,"Action,Adventure,Comedy",7.3,2015-07-17,130000000,180202163,518858449,699060612,569060612,2015,July,7,summer,Q3
1322,tt1677720,readyplayerone,140,"Action,Adventure,Sci-Fi",7.5,2018-03-29,150000000,137690172,579290136,716980308,566980308,2018,March,3,spring,Q1
2867,tt3874544,thebossbaby,97,"Adventure,Animation,Comedy",6.3,2017-03-31,125000000,175003033,510878762,685881795,560881795,2017,March,3,spring,Q1
2400,tt2510894,hoteltransylvania2,89,"Animation,Comedy,Family",6.7,2015-09-25,80000000,169700110,469500298,639200408,559200408,2015,September,9,Fall,Q3
2845,tt3783958,lalaland,128,"Comedy,Drama,Music",8.0,2016-12-09,20000000,151101803,426351163,577452966,557452966,2016,December,12,winter/holiday,Q4
571,tt1318514,riseoftheplanetoftheapes,105,"Action,Drama,Sci-Fi",7.6,2011-08-05,93000000,176760185,470986200,647746385,554746385,2011,August,8,summer,Q3
402,tt1216475,cars2,106,"Adventure,Animation,Comedy",6.2,2011-06-24,200000000,191450875,560155383,751606258,551606258,2011,June,6,summer,Q2
537,tt1291150,teenagemutantninjaturtles,101,"Action,Adventure,Comedy",5.8,2014-08-08,125000000,191204754,485004754,676209508,551209508,2014,August,8,summer,Q3
3123,tt5848272,ralphbreakstheinternet,112,"Adventure,Animation,Comedy",7.1,2018-11-21,175000000,201091711,524283695,725375406,550375406,2018,November,11,Fall,Q4
142,tt0892769,howtotrainyourdragon,98,"Action,Adventure,Animation",8.1,2010-03-26,165000000,217581232,494870992,712452224,547452224,2010,March,3,spring,Q1
2830,tt3731562,kongskullisland,118,"Action,Adventure,Fantasy",6.6,2017-03-10,185000000,168052812,561072059,729124871,544124871,2017,March,3,spring,Q1
2535,tt2872732,lucy,89,"Action,Sci-Fi,Thriller",6.4,2014-07-25,40000000,126573960,457507776,584081736,544081736,2014,July,7,summer,Q3
109,tt0816711,worldwarz,116,"Action,Adventure,Horror",7.0,2013-06-21,190000000,202359711,531514650,733874361,543874361,2013,June,6,summer,Q2
759,tt1436562,rio,96,"Adventure,Animation,Comedy",6.9,2011-04-15,90000000,143619809,487519809,631139618,541139618,2011,April,4,spring,Q2
3052,tt5013056,dunkirk,106,"Action,Drama,History",7.9,2017-07-21,150000000,190068280,499837368,689905648,539905648,2017,July,7,summer,Q3
95,tt0800320,clashofthetitans,106,"Action,Adventure,Fantasy",5.8,2010-04-01,125000000,163214888,493214888,656429776,531429776,2010,April,4,spring,Q2
16,tt0398286,tangled,100,"Adventure,Animation,Comedy",7.8,2010-11-24,260000000,200821936,586477240,787299176,527299176,2010,November,11,Fall,Q4
1196,tt1623205,ozthegreatandpowerful,130,"Adventure,Family,Fantasy",6.3,2013-03-08,200000000,234770996,490359051,725130047,525130047,2013,March,3,spring,Q1
2203,tt2267968,kungfupanda3,95,"Action,Adventure,Animation",7.1,2016-01-29,140000000,143528619,517599142,661127761,521127761,2016,January,1,winter/holiday,Q1
1523,tt1772341,wreckitralph,101,"Adventure,Animation,Comedy",7.7,2012-11-02,165000000,189412677,496511521,685924198,520924198,2012,November,11,Fall,Q4
2726,tt3385516,xmenapocalypse,144,"Action,Adventure,Sci-Fi",7.0,2016-05-27,178000000,155442489,542537546,697980035,519980035,2016,May,5,spring,Q2
2695,tt3371366,transformersthelastknight,154,"Action,Adventure,Sci-Fi",5.2,2017-06-21,217000000,130168683,602893340,733062023,516062023,2017,June,6,summer,Q2
1654,tt1853728,djangounchained,165,"Drama,Western",8.4,2012-12-25,100000000,162805434,449948323,612753757,512753757,2012,December,12,winter/holiday,Q4
709,tt1408101,startrekintodarkness,132,"Action,Adventure,Sci-Fi",7.7,2013-05-16,190000000,228778661,467381584,696160245,506160245,2013,May,5,spring,Q2
3142,tt6347308,aquietplace,80,Documentary,6.6,2018-04-06,17000000,188024361,334522294,522546655,505546655,2018,April,4,spring,Q2
1946,tt2126355,sanandreas,114,"Action,Adventure,Drama",6.1,2015-05-29,110000000,155190832,456258539,611449371,501449371,2015,May,5,spring,Q2
3019,tt4779682,themeg,113,"Action,Horror,Sci-Fi",5.7,2018-08-10,178000000,145443742,529530715,674974457,496974457,2018,August,8,summer,Q3
2291,tt2357291,rio2,101,"Adventure,Animation,Comedy",6.3,2014-04-11,130000000,131538435,492846291,624384726,494384726,2014,April,4,spring,Q2
3008,tt4701182,bumblebee,114,"Action,Adventure,Sci-Fi",6.9,2018-12-21,102000000,127195589,465195589,592391178,490391178,2018,December,12,winter/holiday,Q4
336,tt1155076,thekaratekid,140,"Action,Drama,Family",6.2,2010-06-11,40000000,176591618,351774938,528366556,488366556,2010,June,6,summer,Q2
2745,tt3450958,warfortheplanetoftheapes,140,"Action,Adventure,Drama",7.5,2017-07-14,152000000,146880162,489592267,636472429,484472429,2017,July,7,summer,Q3
97,tt0800369,thor,115,"Action,Adventure,Fantasy",7.0,2011-05-06,150000000,181030624,449326618,630357242,480357242,2011,May,5,spring,Q2
895,tt1485796,thegreatestshowman,105,"Biography,Drama,Musical",7.6,2017-12-20,84000000,174340174,386665550,561005724,477005724,2017,December,12,winter/holiday,Q4
2204,tt2267998,gonegirl,149,"Drama,Mystery,Thriller",8.1,2014-10-03,61000000,167767189,368567189,536334378,475334378,2014,October,10,Fall,Q4
2236,tt2294449,22jumpstreet,112,"Action,Comedy,Crime",7.0,2014-06-13,50000000,191719337,331333876,523053213,473053213,2014,June,6,summer,Q2
685,tt1397280,taken2,92,"Action,Thriller",6.3,2012-10-05,45000000,139854287,377807404,517661691,472661691,2012,October,10,Fall,Q4
2930,tt4196776,jasonbourne,123,"Action,Thriller",6.6,2016-07-29,120000000,162192920,416168316,578361236,458361236,2016,July,7,summer,Q3
2525,tt2848292,pitchperfect2,115,"Comedy,Music",6.4,2015-05-15,29000000,184296230,287625468,471921698,442921698,2015,May,5,spring,Q2
119,tt0837562,hoteltransylvania,91,"Animation,Comedy,Family",7.1,2012-09-28,85000000,148313048,378505812,526818860,441818860,2012,September,9,Fall,Q3
2959,tt4465564,fiftyshadesdarker,118,"Drama,Romance",4.6,2017-02-10,55000000,114434010,381398492,495832502,440832502,2017,February,2,winter/holiday,Q1
2517,tt2802144,kingsmanthesecretservice,129,"Action,Adventure,Comedy",7.7,2015-02-13,94000000,128261724,404561724,532823448,438823448,2015,February,2,winter/holiday,Q1
855,tt1457767,theconjuring,112,"Horror,Mystery,Thriller",7.5,2013-07-19,20000000,137400141,318000141,455400282,435400282,2013,July,7,summer,Q3
743,tt1430132,thewolverine,126,"Action,Adventure,Sci-Fi",6.7,2013-07-26,115000000,132556852,416456852,549013704,434013704,2013,July,7,summer,Q3
2015,tt2224026,home,94,"Adventure,Animation,Comedy",6.6,2015-03-27,130000000,177397510,385997896,563395406,433395406,2015,March,3,spring,Q1
3056,tt5052448,getout,104,"Horror,Mystery,Thriller",7.7,2017-02-24,5000000,176040665,255367951,431408616,426408616,2017,February,2,winter/holiday,Q1
886,tt1478338,bridesmaids,125,"Comedy,Romance",6.8,2011-05-13,32500000,169211718,289632023,458843741,426343741,2011,May,5,spring,Q2
155,tt0947798,blackswan,108,"Drama,Thriller",8.0,2010-12-03,13000000,106954678,331266710,438221388,425221388,2010,December,12,winter/holiday,Q4
2433,tt2582846,thefaultinourstars,126,"Drama,Romance",7.7,2014-06-06,12000000,124872350,307166834,432039184,420039184,2014,June,6,summer,Q2
1110,tt1590245,wonder,74,"Comedy,Drama,Horror",4.9,2017-11-17,20000000,132422809,304604712,437027521,417027521,2017,November,11,Fall,Q4
2960,tt4477536,fiftyshadesfreed,105,"Drama,Romance,Thriller",4.5,2018-02-09,55000000,100407760,371350619,471758379,416758379,2018,February,2,winter/holiday,Q1
1537,tt1790864,themazerunner,113,"Action,Mystery,Sci-Fi",6.8,2014-09-19,34000000,102427862,348319861,450747723,416747723,2014,September,9,Fall,Q3
3061,tt5117670,peterrabbit,95,"Adventure,Animation,Comedy",6.6,2018-02-09,50000000,115234093,347136477,462370570,412370570,2018,February,2,winter/holiday,Q1
2447,tt2660118,split,90,"Comedy,Romance,Sport",2.9,2017-01-20,5000000,138141585,278964806,417106391,412106391,2017,January,1,winter/holiday,Q1
2153,tt2231461,rampage,107,"Action,Adventure,Sci-Fi",6.1,2018-04-13,120000000,101028233,428056280,529084513,409084513,2018,April,4,spring,Q2
42,tt0458339,captainamericathefirstavenger,124,"Action,Adventure,Sci-Fi",6.9,2011-07-22,140000000,176654505,370569776,547224281,407224281,2011,July,7,summer,Q3
201,tt0993846,thewolfofwallstreet,180,"Biography,Crime,Drama",8.2,2013-12-25,100000000,116900694,389870414,506771108,406771108,2013,December,12,winter/holiday,Q4
2906,tt4116284,thelegobatmanmovie,104,"Action,Animation,Comedy",7.3,2017-02-10,80000000,175750384,310660018,486410402,406410402,2017,February,2,winter/holiday,Q1
2994,tt4649466,kingsmanthegoldencircle,141,"Action,Adventure,Comedy",6.8,2017-09-22,104000000,100234838,408803696,509038534,405038534,2017,September,9,Fall,Q3
925,tt1502407,halloween,106,"Horror,Thriller",6.6,2018-10-19,10000000,159342015,254900667,414242682,404242682,2018,October,10,Fall,Q4
843,tt1446714,prometheus,124,"Adventure,Mystery,Sci-Fi",7.0,2012-06-08,125000000,126477084,402448265,528925349,403925349,2012,June,6,summer,Q2
1820,tt2004420,neighbors,97,Comedy,6.3,2014-05-09,18000000,150086800,270944428,421031228,403031228,2014,May,5,spring,Q2
1173,tt1615918,alvinandthechipmunkschipwrecked,87,"Adventure,Animation,Comedy",4.4,2011-12-16,80000000,133107389,349088523,482195912,402195912,2011,December,12,winter/holiday,Q4
2228,tt2279373,thespongebobmoviespongeoutofwater,92,"Adventure,Animation,Comedy",6.0,2015-02-06,74000000,162994032,311013181,474007213,400007213,2015,February,2,winter/holiday,Q1
2734,tt3402236,murderontheorientexpress,114,"Crime,Drama,Mystery",6.5,2017-11-10,55000000,102826543,345922730,448749273,393749273,2017,November,11,Fall,Q4
3062,tt5140878,annabellecreation,109,"Horror,Mystery,Thriller",6.5,2017-08-11,15000000,102092201,305384865,407477066,392477066,2017,August,8,summer,Q3
27,tt0443272,lincoln,150,"Biography,Drama,History",7.4,2012-11-09,65000000,182207973,273346281,455554254,390554254,2012,November,11,Fall,Q4
703,tt1403865,truegrit,110,"Adventure,Drama,Western",7.6,2010-12-22,35000000,171243005,252276928,423519933,388519933,2010,December,12,winter/holiday,Q4
1471,tt1735898,snowwhiteandthehuntsman,127,"Action,Adventure,Drama",6.1,2012-06-01,170000000,155136755,401021746,556158501,386158501,2012,June,6,summer,Q2
1311,tt1670345,nowyouseeme,115,"Crime,Mystery,Thriller",7.3,2013-05-31,75000000,117723989,342769200,460493189,385493189,2013,May,5,spring,Q2
3158,tt6966692,greenbook,130,"Biography,Comedy,Drama",8.3,2018-11-16,23000000,85080171,322034439,407114610,384114610,2018,November,11,Fall,Q4
3055,tt5028340,marypoppinsreturns,130,"Comedy,Family,Fantasy",6.9,2018-12-19,130000000,171958438,341528518,513486956,383486956,2018,December,12,winter/holiday,Q4
2604,tt3104988,crazyrichasians,120,"Comedy,Romance",7.0,2018-08-15,30000000,174532921,238099711,412632632,382632632,2018,August,8,summer,Q3
1398,tt1723121,werethemillers,110,"Comedy,Crime",7.0,2013-08-07,37000000,150394119,267816276,418210395,381210395,2013,August,8,summer,Q3
3029,tt4846340,hiddenfigures,127,"Biography,Drama,History",7.8,2016-12-25,25000000,169607287,231771716,401379003,376379003,2016,December,12,winter/holiday,Q4
676,tt1392190,madmaxfuryroad,120,"Action,Adventure,Sci-Fi",8.1,2015-05-15,150000000,153636354,370098020,523734374,373734374,2015,May,5,spring,Q2
1324,tt1679335,trolls,92,"Adventure,Animation,Comedy",6.5,2016-11-04,125000000,153707064,344150134,497857198,372857198,2016,November,11,Fall,Q4
2375,tt2446042,taken3,108,"Action,Thriller",6.0,2015-01-09,48000000,89256424,327656424,416912848,368912848,2015,January,1,winter/holiday,Q1
1555,tt1800241,americanhustle,138,"Crime,Drama",7.2,2013-12-13,40000000,150117807,257878294,407996101,367996101,2013,December,12,winter/holiday,Q4
191,tt0980970,thechroniclesofnarniathevoyageofthedawntreader,113,"Adventure,Family,Fantasy",6.3,2010-12-10,155000000,104386950,418186950,522573900,367573900,2010,December,12,winter/holiday,Q4
608,tt1340138,terminatorgenisys,126,"Action,Adventure,Sci-Fi",6.4,2015-07-01,155000000,89760956,432150894,521911850,366911850,2015,July,7,summer,Q3
2795,tt3606752,cars3,102,"Adventure,Animation,Comedy",6.8,2017-06-16,175000000,152901115,383541369,536442484,361442484,2017,June,6,summer,Q2
2741,tt3416828,iceagecollisioncourse,94,"Adventure,Animation,Comedy",5.7,2016-07-22,105000000,64063008,402156682,466219690,361219690,2016,July,7,summer,Q3
657,tt1375670,grownups,102,Comedy,6.0,2010-06-25,75000000,162001186,272223430,434224616,359224616,2010,June,6,summer,Q2
182,tt0970866,littlefockers,98,"Comedy,Romance",5.5,2010-12-22,100000000,148438600,310650574,459089174,359089174,2010,December,12,winter/holiday,Q4
1101,tt1583421,gijoeretaliation,110,"Action,Adventure,Sci-Fi",5.8,2013-03-27,140000000,122523060,375740705,498263765,358263765,2013,March,3,spring,Q1
850,tt1454029,thehelp,146,Drama,8.1,2011-08-10,25000000,169705587,213120004,382825591,357825591,2011,August,8,summer,Q3
245,tt1045658,silverliningsplaybook,122,"Comedy,Drama,Romance",7.7,2012-11-16,21000000,132092958,236412453,368505411,347505411,2012,November,11,Fall,Q4
312,tt1130884,shutterisland,138,"Mystery,Thriller",8.1,2010-02-19,80000000,128012934,299461782,427474716,347474716,2010,February,2,winter/holiday,Q1
2361,tt2404463,theheat,117,"Action,Comedy,Crime",6.6,2013-06-28,43000000,159581587,229727774,389309361,346309361,2013,June,6,summer,Q2
686,tt1397514,journey2themysteriousisland,94,"Action,Adventure,Comedy",5.8,2012-02-10,79000000,103860290,318146162,422006452,343006452,2012,February,2,winter/holiday,Q1
1627,tt1840309,divergent,139,"Action,Adventure,Mystery",6.7,2014-03-21,85000000,150947895,276014965,426962860,341962860,2014,March,3,spring,Q1
2483,tt2692250,nightatthemuseumsecretofthetomb,98,"Adventure,Comedy,Family",6.2,2014-12-19,127000000,113746621,353756621,467503242,340503242,2014,December,12,winter/holiday,Q4
203,tt1001526,megamind,95,"Action,Animation,Comedy",7.3,2010-11-05,130000000,148415853,321887208,470303061,340303061,2010,November,11,Fall,Q4
687,tt1398426,straightouttacompton,147,"Biography,Drama,History",7.9,2015-08-14,28000000,161197785,202182981,363380766,335380766,2015,August,8,summer,Q3
1265,tt1650062,super8,112,"Mystery,Sci-Fi,Thriller",7.0,2011-06-10,50000000,127004179,257972745,384976924,334976924,2011,June,6,summer,Q2
2678,tt3322940,annabelle,99,"Horror,Mystery,Thriller",5.4,2014-10-03,6500000,84273813,256862920,341136733,334636733,2014,October,10,Fall,Q4
2844,tt3778644,soloastarwarsstory,135,"Action,Adventure,Fantasy",7.0,2018-05-25,275000000,213767512,393151347,606918859,331918859,2018,May,5,spring,Q2
2885,tt4046784,mazerunnerthescorchtrials,131,"Action,Sci-Fi,Thriller",6.3,2015-09-18,61000000,81697192,310566162,392263354,331263354,2015,September,9,Fall,Q3
483,tt1253863,300riseofanempire,102,"Action,Fantasy,War",6.2,2014-03-07,110000000,106580051,330780051,437360102,327360102,2014,March,3,spring,Q1
271,tt1091821,noah,104,Animation,5.6,2014-03-28,130000000,101200044,352831065,454031109,324031109,2014,March,3,spring,Q1
1297,tt1663662,pacificrim,131,"Action,Adventure,Sci-Fi",6.9,2013-07-12,190000000,101802906,411002906,512805812,322805812,2013,July,7,summer,Q3
1207,tt1628841,independencedayresurgence,120,"Action,Adventure,Sci-Fi",5.2,2016-06-24,165000000,103144286,384169424,487313710,322313710,2016,June,6,summer,Q2
192,tt0983193,theadventuresoftintin,107,"Action,Adventure,Animation",7.3,2011-12-21,130000000,77591831,373993951,451585782,321585782,2011,December,12,winter/holiday,Q4
227,tt1024648,argo,120,"Biography,Drama,Thriller",7.7,2012-10-12,44500000,136025503,227140757,363166260,318666260,2012,October,10,Fall,Q4
1731,tt1911658,penguinsofmadagascar,92,"Adventure,Animation,Comedy",6.7,2014-11-26,132000000,83350911,366942531,450293442,318293442,2014,November,11,Fall,Q4
1809,tt1985966,cloudywithachanceofmeatballs2,95,"Adventure,Animation,Comedy",6.4,2013-09-27,78000000,119793567,274392649,394186216,316186216,2013,September,9,Fall,Q3
98,tt0803096,warcraft,123,"Action,Adventure,Fantasy",6.9,2016-06-10,160000000,47225655,425522281,472747936,312747936,2016,June,6,summer,Q2
2471,tt2660888,startrekbeyond,122,"Action,Adventure,Sci-Fi",7.1,2016-07-22,185000000,158848340,335802233,494650573,309650573,2016,July,7,summer,Q3
1836,tt2017020,thesmurfs2,105,"Adventure,Animation,Comedy",5.4,2013-07-31,110000000,71017784,348547523,419565307,309565307,2013,July,7,summer,Q3
1526,tt1778304,paranormalactivity3,83,"Horror,Mystery,Thriller",5.8,2011-10-21,5000000,104028807,207039844,311068651,306068651,2011,October,10,Fall,Q4
614,tt1343092,thegreatgatsby,143,"Drama,Romance",7.3,2013-05-10,190000000,144840419,351040419,495880838,305880838,2013,May,5,spring,Q2
542,tt1293847,xxxreturnofxandercage,107,"Action,Adventure,Thriller",5.2,2017-01-20,85000000,44898413,345033359,389931772,304931772,2017,January,1,winter/holiday,Q1
1909,tt2084970,theimitationgame,114,"Biography,Drama,Thriller",8.0,2014-11-28,15000000,91125143,227740463,318865606,303865606,2014,November,11,Fall,Q4
2648,tt3263904,sully,96,"Biography,Drama",7.5,2016-09-09,60000000,125070033,238524556,363594589,303594589,2016,September,9,Fall,Q3
2607,tt3110958,nowyouseeme2,129,"Action,Adventure,Comedy",6.5,2016-06-10,90000000,65075540,328325007,393400547,303400547,2016,June,6,summer,Q2
2871,tt3890160,babydriver,113,"Action,Crime,Drama",7.6,2017-06-28,34000000,107825862,228104185,335930047,301930047,2017,June,6,summer,Q2
150,tt0938283,thelastairbender,103,"Action,Adventure,Family",4.1,2010-07-01,150000000,131772187,319713881,451486068,301486068,2010,July,7,summer,Q3
2434,tt2592614,residentevilthefinalchapter,107,"Action,Horror,Sci-Fi",5.6,2017-01-27,40000000,26844692,314101190,340945882,300945882,2017,January,1,winter/holiday,Q1
1990,tt2191701,grownups2,101,Comedy,5.4,2013-07-12,80000000,133668525,247023808,380692333,300692333,2013,July,7,summer,Q3
442,tt1232829,21jumpstreet,109,"Action,Comedy,Crime",7.2,2012-03-16,42000000,138447667,202812429,341260096,299260096,2012,March,3,spring,Q1
413,tt1220634,residentevilafterlife,96,"Action,Adventure,Horror",5.9,2010-09-10,57500000,60128566,295874190,356002756,298502756,2010,September,9,Fall,Q3
1505,tt1764651,theexpendables2,103,"Action,Adventure,Thriller",6.6,2012-08-17,100000000,85028192,311979256,397007448,297007448,2012,August,8,summer,Q3
529,tt1284575,badteacher,92,"Comedy,Romance",5.7,2011-06-24,19000000,100292856,215448997,315741853,296741853,2011,June,6,summer,Q2
147,tt0918940,thelegendoftarzan,110,"Action,Adventure,Drama",6.3,2016-07-01,180000000,126643061,348902025,475545086,295545086,2016,July,7,summer,Q3
2281,tt2345759,themummy,110,"Action,Adventure,Fantasy",5.5,2017-06-09,195000000,80101125,409953905,490055030,295055030,2017,June,6,summer,Q2
499,tt1261945,sexandthecity2,146,"Comedy,Drama,Romance",4.4,2010-05-27,95000000,95347692,294680778,390028470,295028470,2010,May,5,spring,Q2
920,tt1499658,horriblebosses,98,"Comedy,Crime",6.9,2011-07-08,35000000,117538559,212417601,329956160,294956160,2011,July,7,summer,Q3
910,tt1489889,centralintelligence,107,"Action,Comedy,Crime",6.3,2016-06-17,50000000,127440871,217194805,344635676,294635676,2016,June,6,summer,Q2
1213,tt1631867,edgeoftomorrow,113,"Action,Sci-Fi",7.9,2014-06-06,178000000,100206256,370541256,470747512,292747512,2014,June,6,summer,Q2
1156,tt1606389,thevow,104,"Drama,Romance",6.8,2012-02-10,30000000,125014030,197618160,322632190,292632190,2012,February,2,winter/holiday,Q1
628,tt1355644,passengers,116,"Drama,Romance,Sci-Fi",7.0,2016-12-21,110000000,100014699,302239672,402254371,292254371,2016,December,12,winter/holiday,Q4
573,tt1320253,theexpendables,103,"Action,Adventure,Thriller",6.5,2010-08-13,82000000,103068524,268268174,371336698,289336698,2010,August,8,summer,Q3
1978,tt2180411,intothewoods,125,"Adventure,Comedy,Drama",6.0,2014-12-25,56200000,128002372,213116401,341118773,284918773,2014,December,12,winter/holiday,Q4
531,tt1285016,thesocialnetwork,120,"Biography,Drama",7.7,2010-10-01,40000000,96962694,224922135,321884829,281884829,2010,October,10,Fall,Q4
2376,tt2452042,thepeanutsmovie,88,"Adventure,Animation,Comedy",7.1,2015-11-06,99000000,130178411,250091610,380270021,281270021,2015,November,11,Fall,Q4
291,tt1109624,paddington,95,"Adventure,Comedy,Family",7.2,2015-01-16,55000000,76223578,258789097,335012675,280012675,2015,January,1,winter/holiday,Q1
1155,tt1606378,agooddaytodiehard,98,"Action,Thriller",5.3,2013-02-14,92000000,67349198,304249198,371598396,279598396,2013,February,2,winter/holiday,Q1
3141,tt6343314,creedii,130,"Drama,Sport",7.2,2018-11-21,50000000,115715889,213591522,329307411,279307411,2018,November,11,Fall,Q4
152,tt0944835,salt,100,"Action,Mystery,Thriller",6.4,2010-07-23,130000000,118311368,290650494,408961862,278961862,2010,July,7,summer,Q3
9,tt0372538,spy,110,"Action,Crime,Drama",6.6,2015-06-05,65000000,110825712,232585748,343411460,278411460,2015,June,6,summer,Q2
1733,tt1915581,magicmike,110,"Comedy,Drama",6.1,2012-06-29,7000000,113721571,170549753,284271324,277271324,2012,June,6,summer,Q2
114,tt0817230,valentinesday,125,"Comedy,Romance",5.7,2010-02-12,52000000,110485654,217569328,328054982,276054982,2010,February,2,winter/holiday,Q1
1840,tt2024432,identitythief,111,"Adventure,Comedy,Crime",5.7,2013-02-08,35000000,134506920,175361578,309868498,274868498,2013,February,2,winter/holiday,Q1
2995,tt4651520,badmoms,100,Comedy,6.2,2016-07-29,20000000,113257297,180998716,294256013,274256013,2016,July,7,summer,Q3
1011,tt1535109,captainphillips,134,"Biography,Drama,Thriller",7.8,2013-10-11,55000000,107136417,220648184,327784601,272784601,2013,October,10,Fall,Q4
125,tt0848537,epic,102,"Adventure,Animation,Family",6.7,2013-05-24,100000000,107518682,262794441,370313123,270313123,2013,May,5,spring,Q2
1799,tt1979388,thegooddinosaur,93,"Adventure,Animation,Comedy",6.7,2015-11-25,187500000,123087120,333771037,456858157,269358157,2015,November,11,Fall,Q4
296,tt1116184,jackass3d,95,"Action,Comedy,Documentary",7.0,2010-10-15,20000000,117229692,171685793,288915485,268915485,2010,October,10,Fall,Q4
357,tt1194173,thebournelegacy,135,"Action,Adventure,Thriller",6.7,2012-08-10,125000000,113203870,280355920,393559790,268559790,2012,August,8,summer,Q3
842,tt1446192,riseoftheguardians,97,"Action,Adventure,Animation",7.3,2012-11-21,145000000,103412758,306900902,410313660,265313660,2012,November,11,Fall,Q4
1841,tt2024469,nonstop,106,"Action,Mystery,Thriller",7.0,2014-02-28,50000000,91742160,222383055,314125215,264125215,2014,February,2,winter/holiday,Q1
2737,tt3411444,ferdinand,108,"Adventure,Animation,Comedy",6.7,2017-12-15,111000000,84410380,289847930,374258310,263258310,2017,December,12,winter/holiday,Q4
710,tt1408253,ridealong,99,"Action,Comedy,Crime",6.2,2014-01-17,25000000,134202565,153733800,287936365,262936365,2014,January,1,winter/holiday,Q1
2961,tt4500922,mazerunnerthedeathcure,143,"Action,Sci-Fi,Thriller",6.2,2018-01-26,61000000,58032443,265878536,323910979,262910979,2018,January,1,winter/holiday,Q1
1020,tt1536044,paranormalactivity2,91,Horror,5.7,2010-10-20,3000000,84752907,177512032,262264939,259264939,2010,October,10,Fall,Q4
1009,tt1535108,elysium,109,"Action,Drama,Sci-Fi",6.6,2013-08-09,120000000,93050117,286192091,379242208,259242208,2013,August,8,summer,Q3
892,tt1483013,oblivion,124,"Action,Adventure,Sci-Fi",7.0,2013-04-19,120000000,89107235,287916633,377023868,257023868,2013,April,4,spring,Q2
2409,tt2543164,arrival,116,"Drama,Mystery,Sci-Fi",7.9,2016-11-11,47000000,100546139,203127894,303674033,256674033,2016,November,11,Fall,Q4
3034,tt4877122,theemojimovie,86,"Adventure,Animation,Comedy",3.2,2017-07-28,50000000,86089513,216562312,302651825,252651825,2017,July,7,summer,Q3
3032,tt4849438,baahubali2theconclusion,167,"Action,Drama",8.3,2017-04-28,30000000,18985794,263502914,282488708,252488708,2017,April,4,spring,Q2
1076,tt1568346,thegirlwiththedragontattoo,158,"Crime,Drama,Mystery",7.8,2011-12-20,90000000,102515793,239373970,341889763,251889763,2011,December,12,winter/holiday,Q4
1130,tt1599348,safehouse,115,"Action,Adventure,Crime",6.8,2012-02-10,85000000,126181630,208542162,334723792,249723792,2012,February,2,winter/holiday,Q1
429,tt1229340,anchorman2thelegendcontinues,119,Comedy,6.3,2013-12-18,50000000,127352707,172185754,299538461,249538461,2013,December,12,winter/holiday,Q4
3116,tt5758778,skyscraper,102,"Action,Adventure,Thriller",5.8,2018-07-13,125000000,68420120,304115534,372535654,247535654,2018,July,7,summer,Q3
435,tt1231583,duedate,95,"Adventure,Comedy",6.5,2010-11-05,65000000,100539043,211739043,312278086,247278086,2010,November,11,Fall,Q4
458,tt1243957,thetourist,103,"Action,Adventure,Thriller",6.0,2010-12-10,100000000,67631157,278731369,346362526,246362526,2010,December,12,winter/holiday,Q4
1214,tt1632705,creed,77,Horror,6.6,2015-11-25,37000000,109767581,173567581,283335162,246335162,2015,November,11,Fall,Q4
3016,tt4765284,pitchperfect3,93,"Comedy,Music",5.8,2017-12-22,45000000,104897530,185736412,290633942,245633942,2017,December,12,winter/holiday,Q4
2568,tt2974918,alvinandthechipmunkstheroadchip,92,"Adventure,Animation,Comedy",5.1,2015-12-18,90000000,85886987,249517956,335404943,245404943,2015,December,12,winter/holiday,Q4
2478,tt2674426,mebeforeyou,106,"Drama,Romance",7.4,2016-06-03,20000000,56245075,208265198,264510273,244510273,2016,June,6,summer,Q2
1144,tt1605630,americanreunion,113,Comedy,6.7,2012-04-06,50000000,56758835,236799211,293558046,243558046,2012,April,4,spring,Q2
635,tt1365519,tombraider,119,"Action,Adventure,Fantasy",6.3,2018-03-16,90000000,58250803,273477501,331728304,241728304,2018,March,3,spring,Q1
2145,tt2226417,insidiouschapter2,106,"Horror,Mystery,Thriller",6.6,2013-09-13,5000000,83586447,161921515,245507962,240507962,2013,September,9,Fall,Q3
3091,tt5580390,theshapeofwater,123,"Adventure,Drama,Fantasy",7.3,2017-12-01,19500000,63859435,195790794,259650229,240150229,2017,December,12,winter/holiday,Q4
41,tt0455944,theequalizer,132,"Action,Crime,Thriller",7.2,2014-09-26,55000000,101530738,192903624,294434362,239434362,2014,September,9,Fall,Q3
22,tt0433035,realsteel,127,"Action,Drama,Family",7.1,2011-10-07,110000000,85463309,263880341,349343650,239343650,2011,October,10,Fall,Q4
1999,tt2203939,theotherwoman,109,"Comedy,Romance",6.0,2014-04-25,40000000,83911193,195111193,279022386,239022386,2014,April,4,spring,Q2
1252,tt1646987,wrathofthetitans,99,"Action,Adventure,Fantasy",5.7,2012-03-30,150000000,83670083,305270083,388940166,238940166,2012,March,3,spring,Q1
235,tt1033575,thedescendants,115,"Comedy,Drama",7.3,2011-11-16,20000000,82624961,175507800,258132761,238132761,2011,November,11,Fall,Q4
1068,tt1564367,justgowithit,117,"Comedy,Romance",6.4,2011-02-11,80000000,103028109,214974953,318003062,238003062,2011,February,2,winter/holiday,Q1
93,tt0790724,jackreacher,130,"Action,Crime,Thriller",7.0,2012-12-21,60000000,80070736,217370736,297441472,237441472,2012,December,12,winter/holiday,Q4
129,tt0864835,mrpeabodysherman,92,"Adventure,Animation,Comedy",6.8,2014-03-07,145000000,111506430,269806430,381312860,236312860,2014,March,3,spring,Q1
1665,tt1860353,turbo,96,"Adventure,Animation,Comedy",6.4,2013-07-17,135000000,83028130,286896578,369924708,234924708,2013,July,7,summer,Q3
270,tt1091191,lonesurvivor,121,"Action,Biography,Drama",7.5,2013-12-25,40000000,125095601,149804632,274900233,234900233,2013,December,12,winter/holiday,Q4
355,tt1192628,rango,107,"Adventure,Animation,Comedy",7.2,2011-03-04,135000000,123477607,245724600,369202207,234202207,2011,March,3,spring,Q1
717,tt1411704,hop,95,"Adventure,Animation,Comedy",5.4,2011-04-01,63000000,108085305,188657593,296742898,233742898,2011,April,4,spring,Q2
2299,tt2361509,theintern,121,"Comedy,Drama",7.1,2015-09-25,40000000,75764672,197115710,272880382,232880382,2015,September,9,Fall,Q3
1937,tt2120120,pixels,105,"Action,Comedy,Sci-Fi",5.6,2015-07-24,90000000,78765986,244041804,322807790,232807790,2015,July,7,summer,Q3
2440,tt2637276,ted2,115,Comedy,6.3,2015-06-26,68000000,81476385,217214143,298690528,230690528,2015,June,6,summer,Q2
1849,tt2034800,thegreatwall,103,"Action,Adventure,Fantasy",6.0,2017-02-17,150000000,45157105,334486852,379643957,229643957,2017,February,2,winter/holiday,Q1
2785,tt3564472,girlstrip,122,"Comedy,Drama",6.2,2017-07-21,28000000,115108515,140886353,255994868,227994868,2017,July,7,summer,Q3
133,tt0879870,eatpraylove,133,"Drama,Romance",5.8,2010-08-13,60000000,80574010,206598789,287172799,227172799,2010,August,8,summer,Q3
407,tt1217613,battlelosangeles,116,"Action,Sci-Fi",5.8,2011-03-11,70000000,83552429,213463976,297016405,227016405,2011,March,3,spring,Q1
463,tt1245526,red,111,"Action,Comedy,Crime",7.1,2010-10-15,60000000,90380162,196439693,286819855,226819855,2010,October,10,Fall,Q4
3114,tt5726086,insidiousthelastkey,103,"Horror,Mystery,Thriller",5.7,2018-01-05,10000000,67745330,167885588,235630918,225630918,2018,January,1,winter/holiday,Q1
556,tt1302067,yogibear,80,"Adventure,Animation,Comedy",4.6,2010-12-17,80000000,100246011,204774690,305020701,225020701,2010,December,12,winter/holiday,Q4
1876,tt2069955,themule,96,"Crime,Drama,Mystery",4.3,2018-12-14,50000000,103804407,170857676,274662083,224662083,2018,December,12,winter/holiday,Q4
1726,tt1907668,flight,138,"Drama,Thriller",7.3,2012-11-02,31000000,93772375,160558438,254330813,223330813,2012,November,11,Fall,Q4
2978,tt4575576,christopherrobin,104,"Adventure,Animation,Comedy",7.3,2018-08-03,75000000,99215042,197504758,296719800,221719800,2018,August,8,summer,Q3
742,tt1428538,hanselgretelwitchhunters,88,"Action,Fantasy,Horror",6.1,2013-01-25,50000000,55703475,214949716,270653191,220653191,2013,January,1,winter/holiday,Q1
484,tt1253864,immortals,110,"Action,Drama,Fantasy",6.0,2011-11-11,75000000,83504017,211562435,295066452,220066452,2011,November,11,Fall,Q4
1364,tt1700841,sausageparty,89,"Adventure,Animation,Comedy",6.2,2016-08-12,19000000,97670358,141344255,239014613,220014613,2016,August,8,summer,Q3
208,tt1013743,knightandday,109,"Action,Adventure,Comedy",6.3,2010-06-23,117000000,76423035,258751370,335174405,218174405,2010,June,6,summer,Q2
1659,tt1855325,residentevilretribution,95,"Action,Horror,Sci-Fi",5.4,2012-09-14,65000000,42345531,240647629,282993160,217993160,2012,September,9,Fall,Q3
159,tt0955308,robinhood,140,"Action,Adventure,Drama",6.6,2010-05-14,210000000,105487148,322459006,427946154,217946154,2010,May,5,spring,Q2
199,tt0990407,thegreenhornet,119,"Action,Comedy,Crime",5.8,2011-01-14,110000000,98780042,229155503,327935545,217935545,2011,January,1,winter/holiday,Q1
1844,tt2024544,12yearsaslave,134,"Biography,Drama,History",8.1,2013-10-18,20000000,56671993,181025343,237697336,217697336,2013,October,10,Fall,Q4
3132,tt6182908,smallfoot,96,"Adventure,Animation,Comedy",6.7,2018-09-28,80000000,83240103,213691277,296931380,216931380,2018,September,9,Fall,Q3
103,tt0814255,percyjacksontheolympiansthelightningthief,118,"Adventure,Family,Fantasy",5.9,2010-02-12,95000000,88768303,223050874,311819177,216819177,2010,February,2,winter/holiday,Q1
2617,tt3152624,trainwreck,125,"Comedy,Drama,Romance",6.2,2015-07-17,35000000,110212700,141123897,251336597,216336597,2015,July,7,summer,Q3
2491,tt2713180,fury,134,"Action,Drama,War",7.6,2014-10-17,80000000,85817906,210315681,296133587,216133587,2014,October,10,Fall,Q4
502,tt1267297,hercules,98,"Action,Adventure,Fantasy",6.0,2014-07-25,100000000,72688614,243388614,316077228,216077228,2014,July,7,summer,Q3
2264,tt2316204,aliencovenant,122,"Horror,Sci-Fi,Thriller",6.4,2017-05-19,97000000,74262031,238521247,312783278,215783278,2017,May,5,spring,Q2
2840,tt3766354,theequalizer2,121,"Action,Crime,Thriller",6.7,2018-07-20,77000000,102084362,190453132,292537494,215537494,2018,July,7,summer,Q3
1574,tt1809398,unbroken,137,"Biography,Drama,Sport",7.2,2014-12-25,65000000,115637895,163527824,279165719,214165719,2014,December,12,winter/holiday,Q4
534,tt1289401,ghostbusters,116,"Action,Comedy,Fantasy",5.2,2016-07-15,144000000,128350574,229008658,357359232,213359232,2016,July,7,summer,Q3
178,tt0964517,thefighter,116,"Biography,Drama,Sport",7.8,2010-12-10,11000000,93617009,129262388,222879397,211879397,2010,December,12,winter/holiday,Q4
3135,tt6294822,thepost,116,"Biography,Drama,History",7.2,2017-12-22,50000000,81903458,179748880,261652338,211652338,2017,December,12,winter/holiday,Q4
265,tt1085448,lightsout,104,Drama,6.6,2016-07-22,5000000,67268835,148806510,216075345,211075345,2016,July,7,summer,Q3
408,tt1219289,limitless,105,"Mystery,Sci-Fi,Thriller",7.4,2011-03-18,27000000,79249455,155564919,234814374,207814374,2011,March,3,spring,Q1
120,tt0840361,thetown,125,"Crime,Drama,Thriller",7.6,2010-09-17,37000000,92186262,152566881,244753143,207753143,2010,September,9,Fall,Q3
524,tt1276104,looper,113,"Action,Crime,Drama",7.4,2012-09-28,30000000,66486205,170466405,236952610,206952610,2012,September,9,Fall,Q3
116,tt0829150,draculauntold,92,"Action,Drama,Fantasy",6.3,2014-10-10,70000000,55991880,220241723,276233603,206233603,2014,October,10,Fall,Q4
1560,tt1805319,mama,50,Drama,4.5,2013-01-18,15000000,71628180,148095566,219723746,204723746,2013,January,1,winter/holiday,Q1
2323,tt2387589,thegirlonthetrain,80,Thriller,4.4,2016-10-07,45000000,75395035,174278214,249673249,204673249,2016,October,10,Fall,Q4
365,tt1204342,themuppets,103,"Adventure,Comedy,Family",7.1,2011-11-23,45000000,88625922,160971922,249597844,204597844,2011,November,11,Fall,Q4
1914,tt2096672,dumbanddumberto,109,"Adventure,Comedy",5.6,2014-11-14,40000000,86208010,156553592,242761602,202761602,2014,November,11,Fall,Q4
3053,tt5027774,threebillboardsoutsideebbingmissouri,115,"Crime,Drama",8.2,2017-11-10,12000000,54513740,160191915,214705655,202705655,2017,November,11,Fall,Q4
2245,tt2302755,olympushasfallen,119,"Action,Thriller",6.5,2013-03-22,70000000,98927592,172878928,271806520,201806520,2013,March,3,spring,Q1
2492,tt2719848,everest,121,"Action,Adventure,Biography",7.1,2015-09-18,65000000,43482270,221297061,264779331,199779331,2015,September,9,Fall,Q3
1954,tt2140479,theaccountant,128,"Action,Crime,Drama",7.3,2016-10-14,40000000,86260045,152962083,239222128,199222128,2016,October,10,Fall,Q4
2663,tt3300542,londonhasfallen,99,"Action,Thriller",5.9,2016-03-04,60000000,62524260,195194085,257718345,197718345,2016,March,3,spring,Q1
194,tt0989757,dearjohn,108,"Drama,Romance,War",6.3,2010-02-05,25000000,80014842,142033509,222048351,197048351,2010,February,2,winter/holiday,Q1
1934,tt2119532,hacksawridge,139,"Biography,Drama,History",8.1,2016-11-04,40000000,67209615,168904682,236114297,196114297,2016,November,11,Fall,Q4
462,tt1245492,thisistheend,107,"Comedy,Fantasy",6.6,2013-06-12,32000000,101470202,126539117,228009319,196009319,2013,June,6,summer,Q2
526,tt1279935,datenight,88,"Comedy,Crime,Romance",6.3,2010-04-09,55000000,98711404,152269033,250980437,195980437,2010,April,4,spring,Q2
2416,tt2557478,pacificrimuprising,111,"Action,Adventure,Sci-Fi",5.6,2018-03-23,155000000,59874525,290930148,350804673,195804673,2018,March,3,spring,Q1
713,tt1411238,nostringsattached,108,"Comedy,Romance",6.2,2011-01-21,25000000,70662220,149228078,219890298,194890298,2011,January,1,winter/holiday,Q1
2813,tt3682448,bridgeofspies,142,"Drama,History,Thriller",7.6,2015-10-16,40000000,72313754,162498338,234812092,194812092,2015,October,10,Fall,Q4
1000,tt1528100,exodusgodsandkings,150,"Action,Adventure,Drama",6.0,2014-12-12,140000000,65014513,268314513,333329026,193329026,2014,December,12,winter/holiday,Q4
3129,tt6133466,thefirstpurge,98,"Action,Horror,Sci-Fi",5.1,2018-07-04,13000000,69488745,136617305,206106050,193106050,2018,July,7,summer,Q3
1192,tt1621045,thinklikeaman,122,"Comedy,Romance",6.6,2012-04-20,12000000,91547205,113373764,204920969,192920969,2012,April,4,spring,Q2
2876,tt3949660,teenagemutantninjaturtlesoutoftheshadows,112,"Action,Adventure,Comedy",6.0,2016-06-03,135000000,82051601,245328374,327379975,192379975,2016,June,6,summer,Q2
2226,tt2278388,thegrandbudapesthotel,99,"Adventure,Comedy,Crime",8.1,2014-03-07,31000000,59076019,163981261,223057280,192057280,2014,March,3,spring,Q1
1927,tt2109184,paranormalactivity4,88,"Horror,Mystery,Thriller",4.6,2012-10-19,5000000,53900335,142817992,196718327,191718327,2012,October,10,Fall,Q4
662,tt1386588,theotherguys,107,"Action,Comedy,Crime",6.7,2010-08-06,100000000,119219978,170936470,290156448,190156448,2010,August,8,summer,Q3
1810,tt1987680,theupside,126,"Comedy,Drama",6.7,2019-01-11,37500000,108235497,119024536,227260033,189760033,2019,January,1,winter/holiday,Q1
1154,tt1605783,midnightinparis,94,"Comedy,Fantasy,Romance",7.7,2011-05-20,30000000,56816662,162502774,219319436,189319436,2011,May,5,spring,Q2
2831,tt3741834,lion,118,"Biography,Drama",8.1,2016-11-25,12000000,51739495,149570720,201310215,189310215,2016,November,11,Fall,Q4
2903,tt4094724,thepurgeelectionyear,108,"Action,Horror,Sci-Fi",6.0,2016-07-01,10000000,79042440,118514727,197557167,187557167,2016,July,7,summer,Q3
2986,tt4624424,storks,87,"Adventure,Animation,Comedy",6.8,2016-09-23,70000000,72679278,183353431,256032709,186032709,2016,September,9,Fall,Q3
2420,tt2567026,alicethroughthelookingglass,113,"Adventure,Family,Fantasy",6.2,2016-05-27,170000000,77042381,276928112,353970493,183970493,2016,May,5,spring,Q2
2340,tt2398241,smurfsthelostvillage,90,"Adventure,Animation,Comedy",6.0,2017-04-07,60000000,45020282,197578586,242598868,182598868,2017,April,4,spring,Q2
1577,tt1815862,afterearth,100,"Action,Adventure,Drama",4.8,2013-05-31,130000000,60522097,251499665,312021762,182021762,2013,May,5,spring,Q2
446,tt1234721,robocop,117,"Action,Crime,Sci-Fi",6.2,2014-02-12,120000000,58607007,242981799,301588806,181588806,2014,February,2,winter/holiday,Q1
1078,tt1570728,crazystupidlove,118,"Comedy,Drama,Romance",7.4,2011-07-29,50000000,84351197,147142328,231493525,181493525,2011,July,7,summer,Q3
247,tt1051904,goosebumps,103,"Adventure,Comedy,Family",6.3,2015-10-16,58000000,80069458,158905324,238974782,180974782,2015,October,10,Fall,Q4
1744,tt1929263,heavenisforreal,99,"Biography,Drama,Family",5.8,2014-04-16,12000000,91386097,100916299,192302396,180302396,2014,April,4,spring,Q2
1656,tt1854564,percyjacksonseaofmonsters,106,"Adventure,Family,Fantasy",5.8,2013-08-07,90000000,68559554,200859554,269419108,179419108,2013,August,8,summer,Q3
2593,tt3062096,inferno,121,"Action,Adventure,Crime",6.2,2016-10-28,75000000,34343574,219519367,253862941,178862941,2016,October,10,Fall,Q4
356,tt1193631,stepup3d,107,"Drama,Music,Romance",6.2,2010-08-06,30000000,42400223,165889117,208289340,178289340,2010,August,8,summer,Q3
1538,tt1790885,zerodarkthirty,157,"Drama,Thriller",7.4,2012-12-19,52500000,95720716,134612435,230333151,177833151,2012,December,12,winter/holiday,Q4
2971,tt4555426,darkesthour,125,"Biography,Drama,History",7.4,2017-11-22,30000000,56443120,150807172,207250292,177250292,2017,November,11,Fall,Q4
1376,tt1706593,chronicle,84,"Drama,Sci-Fi,Thriller",7.1,2012-02-03,12000000,64575175,123681790,188256965,176256965,2012,February,2,winter/holiday,Q1
3075,tt5308322,happydeathday,96,"Horror,Mystery,Thriller",6.5,2017-10-13,5000000,55683845,125010260,180694105,175694105,2017,October,10,Fall,Q4
2530,tt2869728,ridealong2,102,"Action,Comedy,Crime",5.9,2016-01-15,40000000,90862685,124827316,215690001,175690001,2016,January,1,winter/holiday,Q1
1123,tt1596363,thebigshort,130,"Biography,Comedy,Drama",7.8,2015-12-11,28000000,70259870,133162752,203422622,175422622,2015,December,12,winter/holiday,Q4
347,tt1179933,10cloverfieldlane,103,"Drama,Horror,Mystery",7.2,2016-03-11,5000000,72082999,108286422,180369421,175369421,2016,March,3,spring,Q1
2205,tt2268016,magicmikexxl,115,"Comedy,Drama,Music",5.6,2015-07-01,14500000,66013057,123660597,189673654,175173654,2015,July,7,summer,Q3
1249,tt1645170,thedictator,83,Comedy,6.4,2012-05-16,65000000,59650222,180148897,239799119,174799119,2012,May,5,spring,Q2
2569,tt2975578,thepurgeanarchy,103,"Action,Horror,Sci-Fi",6.5,2014-07-18,9000000,71562550,111534881,183097431,174097431,2014,July,7,summer,Q3
876,tt1469304,baywatch,116,"Action,Comedy,Crime",5.6,2017-05-25,60000000,58060186,175863783,233923969,173923969,2017,May,5,spring,Q2
239,tt1037705,thebookofeli,118,"Action,Adventure,Drama",6.9,2010-01-15,80000000,94835059,158750817,253585876,173585876,2010,January,1,winter/holiday,Q1
246,tt1047540,parentalguidance,105,"Comedy,Family",6.1,2012-12-25,25000000,77267296,120832383,198099679,173099679,2012,December,12,winter/holiday,Q4
3144,tt6359956,abadmomschristmas,104,"Adventure,Comedy",5.5,2017-11-01,28000000,72110659,127710550,199821209,171821209,2017,November,11,Fall,Q4
2305,tt2369135,needforspeed,132,"Action,Crime,Thriller",6.5,2014-03-14,66000000,43568507,194169619,237738126,171738126,2014,March,3,spring,Q1
414,tt1222817,zookeeper,102,"Comedy,Family,Romance",5.2,2011-07-08,80000000,80360866,170805525,251166391,171166391,2011,July,7,summer,Q3
718,tt1412386,thebestexoticmarigoldhotel,124,"Comedy,Drama,Romance",7.3,2012-05-04,10000000,46383639,134639780,181023419,171023419,2012,May,5,spring,Q2
1124,tt1596365,thewomaninblack,95,"Drama,Fantasy,Horror",6.4,2012-02-03,15000000,54333290,128955898,183289188,168289188,2012,February,2,winter/holiday,Q1
262,tt1077368,darkshadows,113,"Comedy,Fantasy,Horror",6.2,2012-05-11,150000000,79727149,238202668,317929817,167929817,2012,May,5,spring,Q2
1227,tt1637688,intime,109,"Action,Crime,Drama",6.7,2011-10-28,35000000,37553932,165103952,202657884,167657884,2011,October,10,Fall,Q4
1558,tt1800741,stepuprevolution,99,"Drama,Music,Romance",6.5,2012-07-27,33000000,35074677,165552290,200626967,167626967,2012,July,7,summer,Q3
1220,tt1632708,friendswithbenefits,109,"Comedy,Romance",6.6,2011-07-22,35000000,55802754,146595891,202398645,167398645,2011,July,7,summer,Q3
1974,tt2177771,themonumentsmen,118,"Comedy,Drama,History",6.1,2014-02-07,70000000,78031620,158702748,236734368,166734368,2014,February,2,winter/holiday,Q1
1077,tt1568911,warhorse,146,"Drama,History,War",7.2,2011-12-25,70000000,79883359,156815529,236698888,166698888,2011,December,12,winter/holiday,Q4
1012,tt1535438,hopesprings,100,"Comedy,Drama,Romance",6.3,2012-08-08,30000000,63536011,133085295,196621306,166621306,2012,August,8,summer,Q3
1661,tt1856101,bladerunner2049,164,"Drama,Mystery,Sci-Fi",8.0,2017-10-06,185000000,92054159,259357408,351411567,166411567,2017,October,10,Fall,Q4
2360,tt2404435,themagnificentseven,132,"Action,Adventure,Western",6.9,2016-09-23,90000000,93432655,162525156,255957811,165957811,2016,September,9,Fall,Q3
1806,tt1981677,pitchperfect,112,"Comedy,Music,Romance",7.2,2012-09-28,17000000,65001093,116044347,181045440,164045440,2012,September,9,Fall,Q3
1952,tt2140373,savingmrbanks,125,"Biography,Comedy,Drama",7.5,2013-12-13,35000000,83299761,114962525,198262286,163262286,2013,December,12,winter/holiday,Q4
154,tt0945513,sourcecode,93,"Action,Drama,Sci-Fi",7.5,2011-04-01,32000000,54712227,140428499,195140726,163140726,2011,April,4,spring,Q2
1652,tt1850457,sisters,118,Comedy,6.0,2015-12-18,30000000,87044645,106030660,193075305,163075305,2015,December,12,winter/holiday,Q4
574,tt1320261,gulliverstravels,85,"Adventure,Comedy,Family",4.9,2010-12-25,112000000,42779261,232017848,274797109,162797109,2010,December,12,winter/holiday,Q4
2630,tt3195644,insidiouschapter3,97,"Horror,Mystery,Thriller",6.1,2015-06-05,10000000,52218558,120453155,172671713,162671713,2015,June,6,summer,Q2
1911,tt2091256,captainunderpantsthefirstepicmovie,89,"Action,Animation,Comedy",6.2,2017-06-02,38000000,73921000,126577874,200498874,162498874,2017,June,6,summer,Q2
883,tt1477076,saw3d,90,"Crime,Horror,Mystery",5.6,2010-10-29,17000000,45710178,133735284,179445462,162445462,2010,October,10,Fall,Q4
3147,tt6450186,icanonlyimagine,110,"Biography,Drama,Family",7.4,2018-03-16,7000000,83482352,85604221,169086573,162086573,2018,March,3,spring,Q1
38,tt0453562,42,128,"Biography,Drama,Sport",7.5,2013-04-12,31000000,95020213,97470701,192490914,161490914,2013,April,4,spring,Q2
1923,tt2103254,tammy,97,"Comedy,Romance",4.9,2014-07-02,20000000,84525432,96407655,180933087,160933087,2014,July,7,summer,Q3
2886,tt4052882,theshallows,86,"Drama,Horror,Thriller",6.3,2016-06-24,13000000,55121623,118763442,173885065,160885065,2016,June,6,summer,Q2
1587,tt1823664,annie,118,"Comedy,Drama,Family",5.3,2014-12-19,65000000,85911262,139829625,225740887,160740887,2014,December,12,winter/holiday,Q4
691,tt1401152,unknown,113,"Action,Mystery,Thriller",6.9,2011-02-18,40000000,63686397,136123083,199809480,159809480,2011,February,2,winter/holiday,Q1
1367,tt1702443,justinbieberneversaynever,105,"Documentary,Music",1.6,2011-02-11,13000000,73013910,99034125,172048035,159048035,2011,February,2,winter/holiday,Q1
1145,tt1605776,thevisit,90,"Comedy,Drama,Romance",8.3,2015-09-11,5000000,65206105,98677816,163883921,158883921,2015,September,9,Fall,Q3
769,tt1440129,battleship,131,"Action,Adventure,Sci-Fi",5.8,2012-05-18,220000000,65233400,313477717,378711117,158711117,2012,May,5,spring,Q2
2729,tt3393786,jackreachernevergoback,118,"Action,Thriller",6.1,2016-10-21,60000000,58697076,159946489,218643565,158643565,2016,October,10,Fall,Q4
241,tt1038919,thebountyhunter,110,"Action,Comedy,Romance",5.6,2010-03-19,45000000,67061228,135808837,202870065,157870065,2010,March,3,spring,Q1
1194,tt1622979,finaldestination5,92,Horror,5.9,2011-08-12,40000000,42587643,155011165,197598808,157598808,2011,August,8,summer,Q3
2316,tt2381941,focus,105,"Comedy,Crime,Drama",6.6,2015-02-27,65000000,53862963,168065700,221928663,156928663,2015,February,2,winter/holiday,Q1
1271,tt1655442,theartist,100,"Comedy,Drama,Romance",7.9,2011-11-25,16000000,44667095,128256712,172923807,156923807,2011,November,11,Fall,Q4
2419,tt2561572,gethard,100,"Comedy,Crime",6.0,2015-03-27,40000000,90411453,106511453,196922906,156922906,2015,March,3,spring,Q1
1582,tt1821658,thenutjob,85,"Adventure,Animation,Comedy",5.7,2014-01-17,30000000,64251538,122529966,186781504,156781504,2014,January,1,winter/holiday,Q1
6,tt0359950,thesecretlifeofwaltermitty,114,"Adventure,Comedy,Drama",7.3,2013-12-25,91000000,58236838,187861183,246098021,155098021,2013,December,12,winter/holiday,Q4
1936,tt2119543,thehousewithaclockinitswalls,105,"Comedy,Fantasy,Horror",6.0,2018-09-21,40000000,68549695,126331750,194881445,154881445,2018,September,9,Fall,Q3
1804,tt1981128,geostorm,109,"Action,Sci-Fi,Thriller",5.3,2017-10-20,100000000,33700160,220796009,254496169,154496169,2017,October,10,Fall,Q4
25,tt0436230,thedevilinside,104,"Horror,Thriller",6.7,2012-01-06,1000000,53262945,101759490,155022435,154022435,2012,January,1,winter/holiday,Q1
1125,tt1597044,mirrormirror,83,"Fantasy,Sci-Fi,Thriller",5.8,2012-03-30,85000000,64935167,173613482,238548649,153548649,2012,March,3,spring,Q1
1127,tt1598778,contagion,106,"Action,Drama,Thriller",6.6,2011-09-09,60000000,75658097,137551594,213209691,153209691,2011,September,9,Fall,Q3
1988,tt2184339,thepurge,85,"Horror,Thriller",5.7,2013-06-07,3000000,64473115,91266581,155739696,152739696,2013,June,6,summer,Q2
914,tt1496025,underworldawakening,88,"Action,Fantasy,Horror",6.4,2012-01-20,70000000,62321039,160379930,222700969,152700969,2012,January,1,winter/holiday,Q1
1114,tt1591095,insidious,103,"Horror,Mystery,Thriller",6.9,2011-04-01,1500000,54009150,99870886,153880036,152380036,2011,April,4,spring,Q2
52,tt0477080,unstoppable,98,"Action,Thriller",6.8,2010-11-12,95000000,81562942,165720921,247283863,152283863,2010,November,11,Fall,Q4
1106,tt1588173,warmbodies,98,"Comedy,Horror,Romance",6.9,2013-02-01,30000000,66380662,115121608,181502270,151502270,2013,February,2,winter/holiday,Q1
3095,tt5599520,nightschool,85,Documentary,7.2,2018-09-28,29000000,77339130,103008792,180347922,151347922,2018,September,9,Fall,Q3
870,tt1464540,iamnumberfour,111,"Action,Adventure,Sci-Fi",6.1,2011-02-18,50000000,55100437,146195159,201295596,151295596,2011,February,2,winter/holiday,Q1
3010,tt4727712,bookclub,72,Documentary,6.6,2018-05-18,10000000,68566296,91113683,159679979,149679979,2018,May,5,spring,Q2
2489,tt2704998,gamenight,100,"Action,Comedy,Crime",7.0,2018-02-23,37000000,69179066,117378084,186557150,149557150,2018,February,2,winter/holiday,Q1
367,tt1204977,ouija,89,"Horror,Mystery,Thriller",4.5,2014-10-24,5000000,50856010,103300632,154156642,149156642,2014,October,10,Fall,Q4
366,tt1204975,lastvegas,105,"Comedy,Drama",6.6,2013-01-28,28000000,63914167,112914167,176828334,148828334,2013,January,1,winter/holiday,Q1
2273,tt2333784,theexpendables3,126,"Action,Adventure,Thriller",6.1,2014-08-15,100000000,39322544,209461378,248783922,148783922,2014,August,8,summer,Q3
1925,tt2106361,intothestorm,89,"Action,Adventure,Drama",5.8,2014-08-08,50000000,47602194,150429371,198031565,148031565,2014,August,8,summer,Q3
516,tt1272878,2guns,109,"Action,Comedy,Crime",6.7,2013-08-02,61000000,75612460,132493015,208105475,147105475,2013,August,8,summer,Q3
1122,tt1596350,thismeanswar,103,"Action,Comedy,Romance",6.3,2012-02-17,65000000,54760791,156974557,211735348,146735348,2012,February,2,winter/holiday,Q1
345,tt1179056,anightmareonelmstreet,95,"Crime,Drama,Horror",5.2,2010-04-30,35000000,63075011,117729621,180804632,145804632,2010,April,4,spring,Q2
1225,tt1636826,projectx,88,Comedy,6.7,2012-03-02,12000000,54731865,103028188,157760053,145760053,2012,March,3,spring,Q1
664,tt1386703,totalrecall,118,"Action,Adventure,Mystery",6.3,2012-08-03,125000000,58877969,211856088,270734057,145734057,2012,August,8,summer,Q3
101,tt0810913,jackandjill,91,Comedy,3.3,2011-11-11,79000000,74158157,150519217,224677374,145677374,2011,November,11,Fall,Q4
20,tt0429493,theateam,117,"Action,Adventure,Thriller",6.8,2010-06-11,110000000,77222099,177241171,254463270,144463270,2010,June,6,summer,Q2
668,tt1389137,weboughtazoo,124,"Comedy,Drama,Family",7.1,2011-12-23,50000000,75624550,118729073,194353623,144353623,2011,December,12,winter/holiday,Q4
2573,tt2980516,thetheoryofeverything,123,"Biography,Drama,Romance",7.7,2014-11-07,15000000,35893537,123327692,159221229,144221229,2014,November,11,Fall,Q4
258,tt1071875,ghostriderspiritofvengeance,96,"Action,Fantasy,Thriller",4.3,2012-02-17,57000000,51774002,149217355,200991357,143991357,2012,February,2,winter/holiday,Q1
48,tt0471042,towerheist,104,"Action,Comedy,Crime",6.2,2011-11-04,85000000,78046570,150422946,228469516,143469516,2011,November,11,Fall,Q4
2744,tt3450650,paulblartmallcop2,94,"Action,Comedy,Crime",4.4,2015-04-17,38000000,71091594,107650646,178742240,140742240,2015,April,4,spring,Q2
1115,tt1591479,actofvalor,110,"Action,Adventure,Drama",6.5,2012-02-24,12000000,70012847,82497035,152509882,140509882,2012,February,2,winter/holiday,Q1
1350,tt1698641,alexanderandtheterriblehorriblenogoodverybadday,81,"Comedy,Family",6.2,2014-10-10,28000000,66954149,101379287,168333436,140333436,2014,October,10,Fall,Q4
1169,tt1615160,theforeigner,113,"Action,Thriller",7.0,2017-10-13,35000000,34393507,140783360,175176867,140176867,2017,October,10,Fall,Q4
2750,tt3460252,thehatefuleight,168,"Crime,Drama,Mystery",7.8,2015-12-25,62000000,54117416,147864886,201982302,139982302,2015,December,12,winter/holiday,Q4
2308,tt2378281,noseaceptandevoluciones,115,"Comedy,Drama",7.6,2013-08-30,5000000,44467206,100486616,144953822,139953822,2013,August,8,summer,Q3
980,tt1524137,contraband,109,"Action,Crime,Drama",6.5,2012-01-13,25000000,66528000,98406855,164934855,139934855,2012,January,1,winter/holiday,Q1
2962,tt4501244,whyhim,111,Comedy,6.2,2016-12-23,38000000,60323786,117425156,177748942,139748942,2016,December,12,winter/holiday,Q4
740,tt1424381,predators,107,"Action,Adventure,Sci-Fi",6.4,2010-07-09,40000000,52000688,127234389,179235077,139235077,2010,July,7,summer,Q3
660,tt1385826,theadjustmentbureau,106,"Romance,Sci-Fi,Thriller",7.1,2011-03-04,50200000,62495645,126931325,189426970,139226970,2011,March,3,spring,Q1
3173,tt7401588,instantfamily,118,"Comedy,Drama",7.4,2018-11-16,48000000,67363237,119736188,187099425,139099425,2018,November,11,Fall,Q4
2854,tt3832914,warroom,120,Drama,6.5,2015-08-28,3000000,67790117,73975239,141765356,138765356,2015,August,8,summer,Q3
253,tt1067583,waterforelephants,120,"Drama,Romance",6.9,2011-04-22,38000000,58709717,116809717,175519434,137519434,2011,April,4,spring,Q2
1366,tt1702439,safehaven,115,"Drama,Romance,Thriller",6.7,2013-02-14,28000000,71399120,94050951,165450071,137450071,2013,February,2,winter/holiday,Q1
2781,tt3532216,americanmade,115,"Action,Biography,Comedy",7.2,2017-09-29,50000000,51342000,135569212,186911212,136911212,2017,September,9,Fall,Q3
383,tt1210166,moneyball,133,"Biography,Drama,Sport",7.6,2011-09-23,50000000,75605492,111300835,186906327,136906327,2011,September,9,Fall,Q3
315,tt1133985,greenlantern,114,"Action,Adventure,Sci-Fi",5.5,2011-06-17,200000000,116601172,219535492,336136664,136136664,2011,June,6,summer,Q2
543,tt1294226,thelastsong,107,"Drama,Music,Romance",6.0,2010-03-31,20000000,62950384,92678948,155629332,135629332,2010,March,3,spring,Q1
533,tt1288558,evildead,91,"Fantasy,Horror,Thriller",6.5,2013-04-05,17000000,54239856,97778356,152018212,135018212,2013,April,4,spring,Q2
2836,tt3760922,mybigfatgreekwedding2,94,"Comedy,Romance",6.0,2016-03-25,18000000,59689605,92096558,151786163,133786163,2016,March,3,spring,Q1
2406,tt2531344,blockers,102,Comedy,6.2,2018-04-06,21000000,60311495,94045328,154356823,133356823,2018,April,4,spring,Q2
1606,tt1838722,truthordare,96,"Horror,Mystery",5.6,2018-04-13,3500000,41411015,95127344,136538359,133038359,2018,April,4,spring,Q2
1742,tt1922777,sinister,110,"Horror,Mystery,Thriller",6.8,2012-10-12,3000000,48086903,87727807,135814710,132814710,2012,October,10,Fall,Q4
595,tt1327194,theluckyone,101,"Drama,Romance",6.5,2012-04-20,25000000,60457138,96633833,157090971,132090971,2012,April,4,spring,Q2
205,tt1007029,theironlady,105,"Biography,Drama",6.4,2012-01-13,14000000,29959436,115592104,145551540,131551540,2012,January,1,winter/holiday,Q1
1067,tt1564349,dolphintale,113,"Drama,Family",6.9,2011-09-23,37000000,72286779,96068724,168355503,131355503,2011,September,9,Fall,Q3
3161,tt7040874,asimplefavor,117,"Comedy,Crime,Drama",6.9,2018-09-14,20000000,53548586,97628717,151177303,131177303,2018,September,9,Fall,Q3
1188,tt1620680,awrinkleintime,109,"Adventure,Family,Fantasy",4.2,2018-03-09,103000000,100478608,133401882,233880490,130880490,2018,March,3,spring,Q1
2693,tt3348730,jigsaw,92,"Crime,Horror,Mystery",5.8,2017-10-27,10000000,38052832,102445196,140498028,130498028,2017,October,10,Fall,Q4
982,tt1524930,vacation,99,"Adventure,Comedy",6.1,2015-07-29,31000000,58884188,102306500,161190688,130190688,2015,July,7,summer,Q3
1777,tt1964418,tomorrowland,130,"Action,Adventure,Family",6.4,2015-05-22,170000000,93436322,206627518,300063840,130063840,2015,May,5,spring,Q2
269,tt1086772,blended,117,"Comedy,Romance",6.5,2014-05-23,45000000,46290741,127990741,174281482,129281482,2014,May,5,spring,Q2
1664,tt1860213,dirtygrandpa,102,Comedy,5.9,2016-01-22,11500000,35593113,105078449,140671562,129171562,2016,January,1,winter/holiday,Q1
2957,tt4438848,neighbors2sororityrising,92,Comedy,5.7,2016-05-20,35000000,55340730,108757621,164098351,129098351,2016,May,5,spring,Q2
2276,tt2334879,whitehousedown,131,"Action,Drama,Thriller",6.4,2013-06-28,150000000,73103784,205440387,278544171,128544171,2013,June,6,summer,Q2
678,tt1392214,prisoners,153,"Crime,Drama,Mystery",8.1,2013-09-20,46000000,61002302,113402302,174404604,128404604,2013,September,9,Fall,Q3
1224,tt1634122,johnnyenglishreborn,101,"Action,Adventure,Comedy",6.3,2011-10-21,45000000,8406711,164640401,173047112,128047112,2011,October,10,Fall,Q4
3170,tt7349662,blackkklansman,135,"Biography,Crime,Drama",7.5,2018-08-10,15000000,49275340,93017335,142292675,127292675,2018,August,8,summer,Q3
528,tt1282140,easya,92,"Comedy,Drama,Romance",7.1,2010-09-17,8000000,58401464,76200721,134602185,126602185,2010,September,9,Fall,Q3
2574,tt2980648,thehundredfootjourney,122,"Comedy,Drama",7.3,2014-08-08,22000000,54235441,94270488,148505929,126505929,2014,August,8,summer,Q3
1907,tt2083355,thebestmanholiday,123,"Comedy,Drama",6.7,2013-11-15,17000000,70525195,72835710,143360905,126360905,2013,November,11,Fall,Q4
360,tt1196141,diaryofawimpykid,94,"Comedy,Drama,Family",6.2,2010-03-19,15000000,64003625,76954311,140957936,125957936,2010,March,3,spring,Q1
2369,tt2431286,philomena,98,"Biography,Comedy,Drama",7.6,2013-11-22,12000000,37709979,98963392,136673371,124673371,2013,November,11,Fall,Q4
100,tt0808510,toothfairy,101,"Comedy,Family,Fantasy",5.0,2010-01-22,48000000,60022256,112610386,172632642,124632642,2010,January,1,winter/holiday,Q1
1772,tt1956620,sextape,94,"Comedy,Romance",5.1,2014-07-18,40000000,38543473,126069509,164612982,124612982,2014,July,7,summer,Q3
2537,tt2873282,redsparrow,140,"Action,Drama,Thriller",6.6,2018-03-02,69000000,46874505,145951861,192826366,123826366,2018,March,3,spring,Q1
1066,tt1563742,overboard,112,"Comedy,Romance",5.9,2018-05-04,12000000,50316123,85369830,135685953,123685953,2018,May,5,spring,Q2
1499,tt1758830,thisis40,134,"Comedy,Romance",6.2,2012-12-21,35000000,67544505,90221182,157765687,122765687,2012,December,12,winter/holiday,Q4
2851,tt3829266,thepredator,107,"Action,Adventure,Sci-Fi",5.4,2018-09-14,88000000,51024708,159487563,210512271,122512271,2018,September,9,Fall,Q3
2937,tt4257926,miraclesfromheaven,109,"Biography,Drama,Family",7.1,2016-03-16,13000000,61705123,73798736,135503859,122503859,2016,March,3,spring,Q1
368,tt1205537,jackryanshadowrecruit,105,"Action,Drama,Thriller",6.2,2014-01-17,60000000,50577412,131377412,181954824,121954824,2014,January,1,winter/holiday,Q1
139,tt0884732,theweddingringer,101,Comedy,6.7,2015-01-16,23000000,64460211,80171596,144631807,121631807,2015,January,1,winter/holiday,Q1
251,tt1055292,lifeasweknowit,114,"Comedy,Drama,Romance",6.6,2010-10-08,38000000,53374681,105887837,159262518,121262518,2010,October,10,Fall,Q4
177,tt0963966,thesorcerersapprentice,109,"Action,Adventure,Family",6.1,2010-07-14,160000000,63150991,217986320,281137311,121137311,2010,July,7,summer,Q3
1965,tt2170439,horriblebosses2,108,"Comedy,Crime",6.3,2014-11-26,40000000,54445357,105945357,160390714,120390714,2014,November,11,Fall,Q4
2362,tt2406566,atomicblonde,115,"Action,Mystery,Thriller",6.7,2017-07-28,30000000,51573925,98345423,149919348,119919348,2017,July,7,summer,Q3
2382,tt2473682,paranormalactivitythemarkedones,84,"Horror,Mystery,Thriller",5.0,2014-01-03,5000000,32462372,90904854,123367226,118367226,2014,January,1,winter/holiday,Q1
2275,tt2334873,bluejasmine,98,Drama,7.3,2013-07-26,18000000,33404871,102912961,136317832,118317832,2013,July,7,summer,Q3
21,tt0431021,thepossession,92,"Horror,Mystery,Thriller",5.9,2012-08-31,14000000,49130588,82925064,132055652,118055652,2012,August,8,summer,Q3
626,tt1355630,ifistay,107,"Drama,Fantasy,Music",6.8,2014-08-22,11000000,50474843,78356170,128831013,117831013,2014,August,8,summer,Q3
481,tt1250777,kickass,117,"Action,Comedy",7.6,2010-04-16,28000000,48071303,97531134,145602437,117602437,2010,April,4,spring,Q2
3037,tt4925292,ladybird,94,"Comedy,Drama",7.4,2017-11-03,10000000,48958273,78610769,127569042,117569042,2017,November,11,Fall,Q4
1717,tt1895587,spotlight,129,"Crime,Drama",8.1,2015-11-06,20000000,45055776,92088460,137144236,117144236,2015,November,11,Fall,Q4
2882,tt4034228,manchesterbythesea,137,Drama,7.8,2016-11-18,8500000,47695371,77733867,125429238,116929238,2016,November,11,Fall,Q4
1548,tt1798684,southpaw,124,"Drama,Sport",7.4,2015-07-24,30000000,52421953,94156456,146578409,116578409,2015,July,7,summer,Q3
2817,tt3691740,thebfg,117,"Adventure,Family,Fantasy",6.4,2016-07-01,140000000,55483770,199646680,255130450,115130450,2016,July,7,summer,Q3
3059,tt5083738,thefavourite,119,"Biography,Drama,History",7.6,2018-11-23,15000000,34366783,94113929,128480712,113480712,2018,November,11,Fall,Q4
2415,tt2555736,thesecondbestexoticmarigoldhotel,122,"Comedy,Drama",6.6,2015-03-06,10000000,33078266,90384306,123462572,113462572,2015,March,3,spring,Q1
2487,tt2702724,theboss,99,Comedy,5.4,2016-04-08,29000000,63077560,78652207,141729767,112729767,2016,April,4,spring,Q2
415,tt1226229,gethimtothegreek,109,"Adventure,Comedy,Music",6.4,2010-06-04,40000000,61153526,91455875,152609401,112609401,2010,June,6,summer,Q2
2580,tt3014284,thelegoninjagomovie,101,"Action,Adventure,Animation",6.0,2017-09-22,70000000,59281555,122737201,182018756,112018756,2017,September,9,Fall,Q3
744,tt1430607,arthurchristmas,97,"Adventure,Animation,Comedy",7.1,2011-11-23,85000000,46462469,149717124,196179593,111179593,2011,November,11,Fall,Q4
1191,tt1621039,freebirds,91,"Adventure,Animation,Comedy",5.9,2013-11-01,55000000,55750480,110387072,166137552,111137552,2013,November,11,Fall,Q4
2162,tt2239832,thinklikeamantoo,106,"Comedy,Romance",5.8,2014-06-20,24000000,65028687,70027933,135056620,111056620,2014,June,6,summer,Q2
1583,tt1821694,red2,116,"Action,Comedy,Crime",6.6,2013-07-19,84000000,53262560,141507355,194769915,110769915,2013,July,7,summer,Q3
541,tt1292566,howtobesingle,110,"Comedy,Drama,Romance",6.1,2016-02-12,37000000,46843513,100003780,146847293,109847293,2016,February,2,winter/holiday,Q1
572,tt1320244,thelastexorcism,87,"Drama,Horror,Thriller",5.6,2010-08-27,1800000,41034350,70165900,111200250,109400250,2010,August,8,summer,Q3
1729,tt1911644,thecall,94,"Crime,Drama,Horror",6.7,2013-03-15,12800000,51872378,69821476,121693854,108893854,2013,March,3,spring,Q1
1572,tt1805411,sonofgod,80,Documentary,6.8,2014-02-28,22000000,59700064,70949793,130649857,108649857,2014,February,2,winter/holiday,Q1
630,tt1355683,blackmass,123,"Biography,Crime,Drama",6.9,2015-09-18,53000000,62575678,98837872,161413550,108413550,2015,September,9,Fall,Q3
1264,tt1650043,diaryofawimpykidrodrickrules,99,"Comedy,Family",6.6,2011-03-25,18000000,52698535,73695194,126393729,108393729,2011,March,3,spring,Q1
3155,tt6791096,ifeelpretty,110,"Comedy,Romance",5.4,2018-04-20,32000000,48795601,91553797,140349398,108349398,2018,April,4,spring,Q2
2249,tt2304933,the5thwave,112,"Action,Adventure,Drama",5.2,2016-01-22,38000000,34912982,111336398,146249380,108249380,2016,January,1,winter/holiday,Q1
229,tt1029360,poltergeist,93,"Horror,Thriller",4.9,2015-05-22,35000000,47425125,95713069,143138194,108138194,2015,May,5,spring,Q2
2950,tt4361050,ouijaoriginofevil,99,"Drama,Horror,Mystery",6.1,2016-10-21,9000000,35144505,81831866,116976371,107976371,2016,October,10,Fall,Q4
2821,tt3717490,powerrangers,124,"Action,Adventure,Sci-Fi",6.0,2017-03-24,120000000,85364450,142531552,227896002,107896002,2017,March,3,spring,Q1
1138,tt1601913,thegrey,117,"Action,Adventure,Drama",6.8,2012-01-27,25000000,51580136,81249176,132829312,107829312,2012,January,1,winter/holiday,Q1
1162,tt1611224,abrahamlincolnvampirehunter,105,"Action,Fantasy,Horror",5.9,2012-06-22,67500000,37519139,137489730,175008869,107508869,2012,June,6,summer,Q2
2163,tt2241351,moneymonster,98,"Crime,Drama,Thriller",6.5,2016-05-13,27000000,41012075,93466095,134478170,107478170,2016,May,5,spring,Q2
2802,tt3622592,papertowns,109,"Comedy,Drama,Mystery",6.3,2015-07-24,12000000,32000304,85450484,117450788,105450788,2015,July,7,summer,Q3
141,tt0892318,letterstojuliet,105,"Adventure,Comedy,Drama",6.6,2010-05-14,30000000,53032453,82148538,135180991,105180991,2010,May,5,spring,Q2
354,tt1189340,thelincolnlawyer,118,"Crime,Drama,Thriller",7.3,2011-03-18,40000000,58009200,87145086,145154286,105154286,2011,March,3,spring,Q1
1801,tt1980209,paingain,129,"Action,Comedy,Crime",6.4,2013-04-26,26000000,49875291,81275291,131150582,105150582,2013,April,4,spring,Q2
3106,tt5664636,goosebumps2hauntedhalloween,90,"Adventure,Comedy,Family",5.6,2018-10-12,35000000,46697321,93291478,139988799,104988799,2018,October,10,Fall,Q4
1839,tt2023453,diaryofawimpykiddogdays,94,"Comedy,Family",6.3,2012-08-03,22000000,49008662,77229695,126238357,104238357,2012,August,8,summer,Q3
3179,tt7784604,hereditary,127,"Drama,Horror,Mystery",7.3,2018-06-08,10000000,44069456,70133905,114203361,104203361,2018,June,6,summer,Q2
1263,tt1648190,thedarktower,95,"Action,Adventure,Fantasy",5.7,2017-08-04,60000000,50701325,113461527,164162852,104162852,2017,August,8,summer,Q3
1197,tt1623288,paranorman,92,"Adventure,Animation,Comedy",7.0,2012-08-17,60000000,56003051,108119662,164122713,104122713,2012,August,8,summer,Q3
927,tt1502712,fantasticfour,100,"Action,Adventure,Drama",4.3,2015-08-07,120000000,56117548,167849187,223966735,103966735,2015,August,8,summer,Q3
1784,tt1967669,tag,91,Drama,4.6,2018-06-15,28000000,54730625,77026186,131756811,103756811,2018,June,6,summer,Q2
88,tt0787474,theboxtrolls,96,"Adventure,Animation,Comedy",6.8,2014-09-26,60000000,50837305,111946251,162783556,102783556,2014,September,9,Fall,Q3
134,tt0881320,sanctum,108,"Adventure,Drama,Thriller",5.9,2011-02-04,30000000,23209310,108957098,132166408,102166408,2011,February,2,winter/holiday,Q1
85,tt0780504,drive,100,"Crime,Drama",7.8,2011-09-16,15000000,35060689,81357930,116418619,101418619,2011,September,9,Fall,Q3
2731,tt3397884,sicario,121,"Action,Crime,Drama",7.6,2015-09-18,30000000,46889293,84393749,131283042,101283042,2015,September,9,Fall,Q3
1380,tt1711525,officechristmasparty,105,Comedy,5.8,2016-12-09,45000000,54767494,91323299,146090793,101090793,2016,December,12,winter/holiday,Q4
674,tt1391137,whydidigetmarriedtoo,121,"Comedy,Drama,Romance",4.6,2010-04-02,20000000,60095852,60831067,120926919,100926919,2010,April,4,spring,Q2
2421,tt2568862,goinginstyle,96,"Comedy,Crime",6.6,2017-04-07,24000000,45018541,78672579,123691120,99691120,2017,April,4,spring,Q2
2866,tt3862750,theperfectguy,100,"Crime,Drama,Horror",5.6,2015-09-11,18000000,57027435,60278166,117305601,99305601,2015,September,9,Fall,Q3
225,tt1020072,selma,128,"Biography,Drama,History",7.5,2015-01-09,20000000,52076908,66776576,118853484,98853484,2015,January,1,winter/holiday,Q1
714,tt1411250,riddick,119,"Action,Adventure,Sci-Fi",6.4,2013-09-06,38000000,42025135,94763758,136788893,98788893,2013,September,9,Fall,Q3
280,tt1092026,paul,104,"Adventure,Comedy,Sci-Fi",7.0,2011-03-18,40000000,37412945,101162106,138575051,98575051,2011,March,3,spring,Q1
412,tt1219827,ghostintheshell,107,"Action,Drama,Sci-Fi",6.4,2017-03-31,110000000,40563557,167910690,208474247,98474247,2017,March,3,spring,Q1
1483,tt1748122,moonrisekingdom,94,"Adventure,Comedy,Drama",7.8,2012-05-25,16000000,45512466,68848446,114360912,98360912,2012,May,5,spring,Q2
1109,tt1590193,thecommuter,105,"Action,Mystery,Thriller",6.3,2018-01-12,40000000,36343858,101985431,138329289,98329289,2018,January,1,winter/holiday,Q1
1299,tt1666186,vampiressuck,82,Comedy,3.4,2010-08-18,20000000,36661504,81424988,118086492,98086492,2010,August,8,summer,Q3
2476,tt2671706,fences,139,Drama,7.2,2016-12-16,24000000,57682904,64282881,121965785,97965785,2016,December,12,winter/holiday,Q4
2197,tt2262227,thebookoflife,95,"Adventure,Animation,Comedy",7.3,2014-10-17,50000000,50151543,97651543,147803086,97803086,2014,October,10,Fall,Q4
779,tt1445206,thegift,105,Documentary,7.6,2015-08-07,5000000,43787265,58978477,102765742,97765742,2015,August,8,summer,Q3
872,tt1465490,joy,75,Drama,6.1,2015-12-25,60000000,56451232,101134059,157585291,97585291,2015,December,12,winter/holiday,Q4
2168,tt2243537,ahauntedhouse,86,"Comedy,Fantasy",5.1,2013-01-11,2500000,40041683,59922558,99964241,97464241,2013,January,1,winter/holiday,Q1
1539,tt1790886,thecampaign,85,Comedy,6.1,2012-08-10,95000000,86907746,104907746,191815492,96815492,2012,August,8,summer,Q3
3066,tt5164432,lovesimon,110,"Comedy,Drama,Romance",7.6,2018-03-16,10000000,40826341,65520633,106346974,96346974,2018,March,3,spring,Q1
317,tt1135084,takers,107,"Action,Crime,Thriller",6.2,2010-08-27,32000000,57744720,70587268,128331988,96331988,2010,August,8,summer,Q3
2819,tt3713166,unfriended,83,"Horror,Mystery,Thriller",5.6,2015-04-17,1000000,32789645,64364198,97153843,96153843,2015,April,4,spring,Q2
300,tt1124035,theidesofmarch,101,"Drama,Thriller",7.1,2011-10-07,23000000,40962534,77735925,118698459,95698459,2011,October,10,Fall,Q4
411,tt1219342,legendoftheguardianstheowlsofgahoole,97,"Action,Adventure,Animation",7.0,2010-09-24,100000000,55675313,139716717,195392030,95392030,2010,September,9,Fall,Q3
492,tt1259528,denofthieves,140,"Action,Crime,Drama",7.0,2018-01-19,30000000,44947622,80131391,125079013,95079013,2018,January,1,winter/holiday,Q1
500,tt1262416,scream4,111,"Horror,Mystery",6.2,2011-04-15,40000000,38180928,95989590,134170518,94170518,2011,April,4,spring,Q2
2371,tt2443822,theboy,105,"Drama,Horror,Thriller",5.4,2016-01-22,10000000,35819556,68220952,104040508,94040508,2016,January,1,winter/holiday,Q1
1831,tt2011159,nogooddeed,84,"Action,Crime,Drama",5.6,2014-09-12,13200000,52543632,54323210,106866842,93666842,2014,September,9,Fall,Q3
338,tt1161864,therite,114,"Drama,Horror,Mystery",6.0,2011-01-28,37000000,33047633,97143987,130191620,93191620,2011,January,1,winter/holiday,Q1
1992,tt2194499,abouttime,123,"Comedy,Drama,Fantasy",7.8,2013-11-01,12000000,15323921,89309178,104633099,92633099,2013,November,11,Fall,Q4
3087,tt5523010,thenutcrackerandthefourrealms,99,"Adventure,Family,Fantasy",5.5,2018-11-02,132900000,54858851,170293899,225152750,92252750,2018,November,11,Fall,Q4
3164,tt7137846,breakingin,88,"Action,Crime,Drama",5.4,2018-05-11,6000000,46840590,51411620,98252210,92252210,2018,May,5,spring,Q2
1103,tt1586265,whattoexpectwhenyoureexpecting,110,"Comedy,Drama,Romance",5.7,2012-05-18,37500000,41152203,88473016,129625219,92125219,2012,May,5,spring,Q2
731,tt1415283,nannymcpheeandthebigbang,109,"Comedy,Family,Fantasy",6.1,2010-08-20,35000000,29197642,97799865,126997507,91997507,2010,August,8,summer,Q3
3084,tt5462602,thebigsick,120,"Comedy,Drama,Romance",7.6,2017-06-23,5000000,42872467,53972860,96845327,91845327,2017,June,6,summer,Q2
3039,tt4975722,moonlight,111,Drama,7.4,2016-10-21,1500000,27854931,65245512,93100443,91600443,2016,October,10,Fall,Q4
391,tt1212419,hereafter,129,"Drama,Fantasy,Romance",6.5,2010-10-15,50000000,32746941,108660270,141407211,91407211,2010,October,10,Fall,Q4
80,tt0765446,escapefromplanetearth,89,"Adventure,Animation,Comedy",5.9,2013-02-15,40000000,57012977,74156610,131169587,91169587,2013,February,2,winter/holiday,Q1
2772,tt3522806,mechanicresurrection,98,"Action,Adventure,Thriller",5.7,2016-08-26,40000000,21218403,109738840,130957243,90957243,2016,August,8,summer,Q3
3058,tt5052474,sicariodayofthesoldado,122,"Action,Crime,Drama",7.1,2018-06-29,35000000,50065850,75885196,125951046,90951046,2018,June,6,summer,Q2
19,tt0427152,dinnerforschmucks,114,Comedy,5.9,2010-07-30,69000000,73026337,86796502,159822839,90822839,2010,July,7,summer,Q3
255,tt1068242,footloose,113,"Comedy,Drama,Music",5.9,2011-10-14,24000000,51802742,62989834,114792576,90792576,2011,October,10,Fall,Q4
399,tt1213641,firstman,141,"Biography,Drama,History",7.4,2018-10-12,60000000,44936545,105203825,150140370,90140370,2018,October,10,Fall,Q4
584,tt1321870,gangstersquad,113,"Action,Crime,Drama",6.7,2013-01-11,60000000,46000903,104100903,150101806,90101806,2013,January,1,winter/holiday,Q1
2862,tt3850590,krampus,98,"Comedy,Fantasy,Horror",6.2,2015-12-04,15000000,42725475,61788393,104513868,89513868,2015,December,12,winter/holiday,Q4
2417,tt2557490,amillionwaystodieinthewest,116,"Comedy,Western",6.1,2014-05-30,40000000,42720965,86778557,129499522,89499522,2014,May,5,spring,Q2
857,tt1458730,brooklyn,80,"Comedy,Crime",7.3,2015-11-04,11000000,38322743,62076141,100398884,89398884,2015,November,11,Fall,Q4
2548,tt2911666,johnwick,101,"Action,Crime,Thriller",7.4,2014-10-24,30000000,43037835,76235001,119272836,89272836,2014,October,10,Fall,Q4
1511,tt1772317,nerve,83,"Comedy,Drama",6.8,2016-07-27,20000000,38583626,70652284,109235910,89235910,2016,July,7,summer,Q3
2521,tt2823054,mikeanddaveneedweddingdates,98,"Adventure,Comedy,Romance",6.0,2016-07-08,33000000,46009673,75898100,121907773,88907773,2016,July,7,summer,Q3
1592,tt1826727,lifeoftheparty,84,"Comedy,Drama",7.6,2018-05-11,30000000,53059911,65759911,118819822,88819822,2018,May,5,spring,Q2
2193,tt2261287,ballerina,89,"Adventure,Animation,Comedy",6.8,2017-08-25,30000000,21858070,96892829,118750899,88750899,2017,August,8,summer,Q3
2307,tt2377322,deliverusfromevil,118,"Horror,Mystery,Thriller",6.2,2014-07-02,30000000,30577122,87956618,118533740,88533740,2014,July,7,summer,Q3
2804,tt3628584,barbershopthenextcut,111,"Comedy,Drama",5.9,2016-04-15,20000000,54030051,54404202,108434253,88434253,2016,April,4,spring,Q2
869,tt1464174,bigmommaslikefatherlikeson,107,"Action,Comedy,Crime",4.4,2011-02-18,32000000,37915414,82332450,120247864,88247864,2011,February,2,winter/holiday,Q1
1750,tt1939659,carrie,100,"Drama,Horror",5.9,2013-10-18,30000000,35266619,82409520,117676139,87676139,2013,October,10,Fall,Q4
1588,tt1823672,chappie,120,"Action,Crime,Drama",6.8,2015-03-06,49000000,31569268,105002056,136571324,87571324,2015,March,3,spring,Q1
2403,tt2515086,onedirectionthisisus,92,"Documentary,Music",4.2,2013-08-30,10000000,28873374,68541786,97415160,87415160,2013,August,8,summer,Q3
897,tt1486185,redridinghood,100,"Fantasy,Horror,Mystery",5.5,2011-03-11,42000000,37662162,91678442,129340604,87340604,2011,March,3,spring,Q1
1796,tt1979320,rush,123,"Action,Biography,Drama",8.1,2013-09-20,38000000,26947624,98230839,125178463,87178463,2013,September,9,Fall,Q3
568,tt1314655,devil,80,"Horror,Mystery,Thriller",6.2,2010-09-17,10000000,33679655,63354114,97033769,87033769,2010,September,9,Fall,Q3
695,tt1402488,happyfeettwo,100,"Adventure,Animation,Comedy",5.9,2011-11-18,135000000,64006466,157956466,221962932,86962932,2011,November,11,Fall,Q4
1174,tt1616195,jedgar,137,"Biography,Crime,Drama",6.6,2011-11-09,35000000,37306030,84606030,121912060,86912060,2011,November,11,Fall,Q4
1947,tt2126357,secondact,103,"Comedy,Drama,Romance",5.8,2018-12-21,15700000,39282227,63288854,102571081,86871081,2018,December,12,winter/holiday,Q4
23,tt0435651,thegiver,97,"Drama,Romance,Sci-Fi",6.5,2014-08-15,25000000,45090374,66540205,111630579,86630579,2014,August,8,summer,Q3
2380,tt2473510,paranormalactivitytheghostdimension,88,"Horror,Mystery,Thriller",4.6,2015-10-23,10000000,18297124,77959374,96256498,86256498,2015,October,10,Fall,Q4
1591,tt1826590,aboutlastnight,100,"Comedy,Romance",6.1,2014-02-14,13000000,48637684,50445860,99083544,86083544,2014,February,2,winter/holiday,Q1
1966,tt2170593,stvincent,102,"Comedy,Drama",7.3,2014-10-10,13000000,44137712,54837234,98974946,85974946,2014,October,10,Fall,Q4
135,tt0882977,snitch,112,"Action,Drama,Thriller",6.5,2013-02-22,15000000,42930462,57907734,100838196,85838196,2013,February,2,winter/holiday,Q1
3051,tt5001718,everythingeverything,96,"Drama,Romance",6.4,2017-05-19,10000000,34121140,61603136,95724276,85724276,2017,May,5,spring,Q2
78,tt0498381,rings,102,"Drama,Horror,Mystery",4.5,2017-02-03,25000000,27793018,82917283,110710301,85710301,2017,February,2,winter/holiday,Q1
2624,tt3181822,theboynextdoor,91,"Horror,Thriller",4.7,2015-01-23,4000000,36006065,53401938,89408003,85408003,2015,January,1,winter/holiday,Q1
228,tt1028576,secretariat,123,"Biography,Drama,Family",7.2,2010-10-08,35000000,59699513,60376247,120075760,85075760,2010,October,10,Fall,Q4
1167,tt1615065,savages,131,"Crime,Drama,Thriller",6.5,2012-07-06,45000000,47323100,82513490,129836590,84836590,2012,July,7,summer,Q3
3022,tt4795124,howtobealatinlover,115,"Comedy,Drama",5.9,2017-04-28,10000000,32149404,62556228,94705632,84705632,2017,April,4,spring,Q2
45,tt0464154,piranha3d,88,"Comedy,Horror",5.4,2010-08-20,24000000,25003155,83660160,108663315,84663315,2010,August,8,summer,Q3
609,tt1340800,tinkertailorsoldierspy,122,"Drama,Mystery,Thriller",7.1,2011-12-09,21000000,24149393,81452811,105602204,84602204,2011,December,12,winter/holiday,Q4
1939,tt2121250,alpha,116,Crime,5.5,2018-08-17,51000000,35851379,99624873,135476252,84476252,2018,August,8,summer,Q3
2979,tt4587656,thestar,86,"Adventure,Animation,Comedy",6.1,2017-11-17,20000000,40847995,62758010,103606005,83606005,2017,November,11,Fall,Q4
1658,tt1855199,endofwatch,109,"Action,Crime,Drama",7.6,2012-09-21,15000000,41003371,57586606,98589977,83589977,2012,September,9,Fall,Q3
772,tt1440728,theamerican,105,"Crime,Drama,Thriller",6.3,2010-09-01,20000000,35606376,67950723,103557099,83557099,2010,September,9,Fall,Q3
91,tt0790636,dallasbuyersclub,117,"Biography,Drama",8.0,2013-11-01,5000000,27298285,60611845,87910130,82910130,2013,November,11,Fall,Q4
490,tt1259521,thecabininthewoods,95,Horror,7.0,2012-04-13,30000000,42073277,70689968,112763245,82763245,2012,April,4,spring,Q2
1534,tt1787759,madeasbighappyfamily,106,"Comedy,Drama",4.7,2011-04-22,25000000,53345287,54160818,107506105,82506105,2011,April,4,spring,Q2
720,tt1413492,12strong,130,"Action,Drama,History",6.6,2018-01-19,35000000,45819713,71118378,116938091,81938091,2018,January,1,winter/holiday,Q1
240,tt1038686,legion,100,"Action,Fantasy,Horror",5.2,2010-01-22,26000000,40168080,67647574,107815654,81815654,2010,January,1,winter/holiday,Q1
1270,tt1655441,theageofadaline,112,"Drama,Fantasy,Romance",7.2,2015-04-24,30000000,42629776,68984536,111614312,81614312,2015,April,4,spring,Q2
2359,tt2404425,womaningold,109,"Biography,Drama,History",7.3,2015-04-01,11000000,33307793,58586407,91894200,80894200,2015,April,4,spring,Q2
17,tt0401729,johncarter,132,"Action,Adventure,Sci-Fi",6.6,2012-03-09,275000000,73058679,282778100,355836779,80836779,2012,March,3,spring,Q1
2157,tt2234155,theinternship,119,Comedy,6.3,2013-06-07,58000000,44672764,93672764,138345528,80345528,2013,June,6,summer,Q2
3004,tt4682786,collateralbeauty,97,"Drama,Romance",6.8,2016-12-16,36000000,31016021,85309093,116325114,80325114,2016,December,12,winter/holiday,Q4
436,tt1231587,hottubtimemachine,101,"Comedy,Sci-Fi",6.4,2010-03-26,36000000,50269859,65967750,116237609,80237609,2010,March,3,spring,Q1
1133,tt1600195,abduction,106,"Action,Mystery,Thriller",5.1,2011-09-23,35000000,28087155,86648359,114735514,79735514,2011,September,9,Fall,Q3
1425,tt1731141,endersgame,114,"Action,Adventure,Fantasy",6.6,2013-11-01,110000000,61737191,127983283,189720474,79720474,2013,November,11,Fall,Q4
1069,tt1564585,skyline,92,"Action,Sci-Fi,Thriller",4.4,2010-11-12,10000000,21416355,68264973,89681328,79681328,2010,November,11,Fall,Q4
1822,tt2005151,wardogs,114,"Comedy,Crime,Drama",7.1,2016-08-19,50000000,43034523,86234503,129269026,79269026,2016,August,8,summer,Q3
2322,tt2387559,deliveryman,105,"Comedy,Drama",6.4,2013-11-22,22000000,30659817,70536870,101196687,79196687,2013,November,11,Fall,Q4
252,tt1065073,boyhood,165,Drama,7.9,2014-07-11,4000000,25379975,57273049,82653024,78653024,2014,July,7,summer,Q3
105,tt0816442,thebookthief,131,"Drama,War",7.6,2013-11-08,19000000,21488481,76086711,97575192,78575192,2013,November,11,Fall,Q4
1182,tt1618442,thelastwitchhunter,106,"Action,Adventure,Fantasy",6.0,2015-10-23,80000000,27367660,130818912,158186572,78186572,2015,October,10,Fall,Q4
397,tt1212436,thebackupplan,104,"Comedy,Romance",5.4,2010-04-23,35000000,37490007,75281179,112771186,77771186,2010,April,4,spring,Q2
321,tt1142977,frankenweenie,87,"Animation,Comedy,Family",7.0,2012-10-05,39000000,35287788,81150788,116438576,77438576,2012,October,10,Fall,Q4
1760,tt1945037,beginagain,68,"Drama,Family",7.0,2014-06-27,8000000,16170632,68838736,85009368,77009368,2014,June,6,summer,Q2
40,tt0455407,thecrazies,101,"Horror,Thriller",6.5,2010-02-26,19000000,39123589,56445534,95569123,76569123,2010,February,2,winter/holiday,Q1
2820,tt3717252,underworldbloodwars,91,"Action,Adventure,Fantasy",5.8,2017-01-06,35000000,30353973,81209222,111563195,76563195,2017,January,1,winter/holiday,Q1
1262,tt1648179,herecomestheboom,105,"Action,Comedy,Sport",6.4,2012-10-12,42000000,45290318,73239258,118529576,76529576,2012,October,10,Fall,Q4
2931,tt4218572,widows,129,"Crime,Drama,Thriller",7.0,2018-11-16,40000000,42402632,73866088,116268720,76268720,2018,November,11,Fall,Q4
60,tt0479997,seasonofthewitch,95,"Action,Adventure,Fantasy",5.4,2011-01-07,40000000,24827228,91126600,115953828,75953828,2011,January,1,winter/holiday,Q1
200,tt0993842,hanna,111,"Action,Drama,Thriller",6.8,2011-04-08,30000000,40259119,65343694,105602813,75602813,2011,April,4,spring,Q2
2161,tt2239822,valerianandthecityofathousandplanets,137,"Action,Adventure,Fantasy",6.5,2017-07-21,180000000,40479370,215098356,255577726,75577726,2017,July,7,summer,Q3
2229,tt2281587,muppetsmostwanted,107,"Adventure,Comedy,Crime",6.4,2014-03-21,55000000,51178893,79312301,130491194,75491194,2014,March,3,spring,Q1
1230,tt1638355,themanfromuncle,116,"Action,Adventure,Comedy",7.3,2015-08-14,75000000,45445109,104949584,150394693,75394693,2015,August,8,summer,Q3
2250,tt2305051,wild,115,"Adventure,Biography,Drama",7.1,2014-12-03,15000000,37880356,52460543,90340899,75340899,2014,December,12,winter/holiday,Q4
305,tt1126591,burlesque,119,"Drama,Music,Musical",6.4,2010-11-24,55000000,39440655,90552675,129993330,74993330,2010,November,11,Fall,Q4
384,tt1210819,theloneranger,150,"Action,Adventure,Western",6.4,2013-07-02,275000000,89302115,260002115,349304230,74304230,2013,July,7,summer,Q3
2533,tt2872718,nightcrawler,117,"Crime,Drama,Thriller",7.9,2014-10-31,8500000,32381218,50334418,82715636,74215636,2014,October,10,Fall,Q4
180,tt0970179,hugo,126,"Adventure,Drama,Family",7.5,2011-11-23,180000000,73864507,180047784,253912291,73912291,2011,November,11,Fall,Q4
501,tt1265990,theroommate,91,"Drama,Thriller",4.9,2011-02-04,16000000,37300107,52545707,89845814,73845814,2011,February,2,winter/holiday,Q1
677,tt1392197,marmaduke,87,"Comedy,Family",4.2,2010-06-04,50000000,33644788,89895930,123540718,73540718,2010,June,6,summer,Q2
1693,tt1872194,thejudge,141,"Crime,Drama",7.4,2014-10-10,50000000,47119388,76119388,123238776,73238776,2014,October,10,Fall,Q4
1915,tt2097298,mcfarlandusa,129,"Biography,Drama,Sport",7.4,2015-02-20,17000000,44480275,45707924,90188199,73188199,2015,February,2,winter/holiday,Q1
1676,tt1869538,life,75,Documentary,7.8,2017-03-24,58000000,30234022,100929666,131163688,73163688,2017,March,3,spring,Q1
1121,tt1596346,soulsurfer,112,"Biography,Drama,Family",7.1,2011-04-08,18000000,43853424,47158652,91012076,73012076,2011,April,4,spring,Q2
3088,tt5580036,itonya,120,"Biography,Comedy,Drama",7.5,2017-12-08,11000000,30014534,53797409,83811943,72811943,2017,December,12,winter/holiday,Q4
1478,tt1742044,jerseyboys,134,"Biography,Drama,Music",6.8,2014-06-20,40000000,47047013,65282732,112329745,72329745,2014,June,6,summer,Q2
3108,tt5690360,slenderman,93,"Horror,Mystery,Thriller",3.2,2018-08-10,10000000,30564825,51723644,82288469,72288469,2018,August,8,summer,Q3
51,tt0475290,hailcaesar,106,"Comedy,Drama,Music",6.3,2016-02-05,22000000,30080225,64160680,94240905,72240905,2016,February,2,winter/holiday,Q1
2502,tt2752772,sinister2,97,"Horror,Mystery,Thriller",5.3,2015-08-21,10000000,27740955,54104225,81845180,71845180,2015,August,8,summer,Q3
2244,tt2296777,sherlockgnomes,86,"Adventure,Animation,Comedy",5.1,2018-03-23,59000000,43242871,87527651,130770522,71770522,2018,March,3,spring,Q1
532,tt1287468,catsdogstherevengeofkittygalore,82,"Action,Comedy,Family",4.3,2010-07-30,85000000,43585753,113026383,156612136,71612136,2010,July,7,summer,Q3
3174,tt7424200,teentitansgotothemovies,84,"Action,Animation,Comedy",6.8,2018-07-27,10000000,29790236,51620593,81410829,71410829,2018,July,7,summer,Q3
1557,tt1800246,thatawkwardmoment,94,"Comedy,Romance",6.2,2014-01-31,8000000,26068955,53068955,79137910,71137910,2014,January,1,winter/holiday,Q1
3169,tt7334528,uncledrew,103,"Comedy,Sport",5.7,2018-06-29,18000000,42469946,46527161,88997107,70997107,2018,June,6,summer,Q2
576,tt1321509,deathatafuneral,92,Comedy,5.7,2010-04-16,21000000,42739347,48977233,91716580,70716580,2010,April,4,spring,Q2
2946,tt4302938,kuboandthetwostrings,101,"Action,Adventure,Animation",7.8,2016-08-19,55000000,48023088,77548122,125571210,70571210,2016,August,8,summer,Q3
2774,tt3530002,thenightbefore,101,"Adventure,Comedy,Fantasy",6.4,2015-11-20,25000000,43035725,52427346,95463071,70463071,2015,November,11,Fall,Q4
961,tt1509767,thethreemusketeers,110,"Action,Adventure,Romance",5.8,2011-10-21,90000000,20377913,139877913,160255826,70255826,2011,October,10,Fall,Q4
3128,tt6063050,acrimony,120,"Drama,Romance,Thriller",5.7,2018-03-30,20000000,43549096,46627836,90176932,70176932,2018,March,3,spring,Q1
2480,tt2679042,hitmanagent47,96,"Action,Adventure,Crime",5.7,2015-08-21,35000000,22467450,82182803,104650253,69650253,2015,August,8,summer,Q3
1663,tt1859650,toromewithlove,112,"Comedy,Music,Romance",6.3,2012-06-22,21500000,16684352,74326015,91010367,69510367,2012,June,6,summer,Q2
73,tt0491152,somethingborrowed,112,"Comedy,Drama,Romance",5.9,2011-05-06,35000000,39046489,65084116,104130605,69130605,2011,May,5,spring,Q2
1304,tt1666801,theduff,101,"Comedy,Romance",6.5,2015-02-20,8500000,34030343,43528634,77558977,69058977,2015,February,2,winter/holiday,Q1
1282,tt1657507,colombiana,108,"Action,Drama,Thriller",6.4,2011-08-26,40000000,36665854,72295262,108961116,68961116,2011,August,8,summer,Q3
1860,tt2053463,sideeffects,106,"Crime,Drama,Mystery",7.1,2013-02-08,30000000,32172757,66742138,98914895,68914895,2013,February,2,winter/holiday,Q1
1099,tt1582507,houseattheendofthestreet,101,"Drama,Horror,Thriller",5.6,2012-09-21,6900000,31611916,44103982,75715898,68815898,2012,September,9,Fall,Q3
1232,tt1640484,jumpingthebroom,112,"Comedy,Drama",5.7,2011-05-06,7000000,37295394,38158601,75453995,68453995,2011,May,5,spring,Q2
14,tt0383010,thethreestooges,92,"Comedy,Family",5.1,2012-04-13,30000000,44338224,54052249,98390473,68390473,2012,April,4,spring,Q2
560,tt1306980,5050,100,"Comedy,Drama,Romance",7.7,2011-09-30,8000000,35016118,41334735,76350853,68350853,2011,September,9,Fall,Q3
1987,tt2183034,earthtoecho,91,"Adventure,Family,Sci-Fi",5.8,2014-07-02,13000000,38934842,42174545,81109387,68109387,2014,July,7,summer,Q3
625,tt1351685,jackthegiantslayer,114,"Adventure,Fantasy",6.3,2013-03-01,195000000,65187603,197687603,262875206,67875206,2013,March,3,spring,Q1
1210,tt1630036,courageous,129,Drama,7.0,2011-09-30,2000000,34522221,35185884,69708105,67708105,2011,September,9,Fall,Q3
286,tt1103153,killers,100,"Action,Comedy,Romance",5.4,2010-06-04,75000000,47059963,95572749,142632712,67632712,2010,June,6,summer,Q2
2993,tt4649416,almostchristmas,111,"Comedy,Drama",6.1,2016-11-11,17000000,42065185,42493506,84558691,67558691,2016,November,11,Fall,Q4
2973,tt4560436,mile22,94,"Action,Adventure,Thriller",6.1,2018-08-17,35000000,36108758,66295121,102403879,67403879,2018,August,8,summer,Q3
2497,tt2726560,thelongestride,123,"Drama,Romance",7.1,2015-04-10,34000000,37446117,63802928,101249045,67249045,2015,April,4,spring,Q2
868,tt1462769,theoddlifeoftimothygreen,105,"Comedy,Drama,Family",6.6,2012-08-15,40000000,51853450,55249159,107102609,67102609,2012,August,8,summer,Q3
1100,tt1583420,larrycrowne,98,"Comedy,Drama,Romance",6.1,2011-07-01,30000000,35608245,61449135,97057380,67057380,2011,July,7,summer,Q3
2331,tt2388715,oculus,104,"Horror,Mystery",6.5,2014-04-11,5000000,27695246,44115496,71810742,66810742,2014,April,4,spring,Q2
2335,tt2390281,max,83,Comedy,5.1,2015-06-26,20000000,42656255,43658157,86314412,66314412,2015,June,6,summer,Q2
416,tt1226273,edgeofdarkness,117,"Crime,Drama,Mystery",6.6,2010-01-29,60000000,43313890,82812456,126126346,66126346,2010,January,1,winter/holiday,Q1
259,tt1072748,winchester,99,"Biography,Drama,Fantasy",5.4,2018-02-02,3500000,25091816,44378040,69469856,65969856,2018,February,2,winter/holiday,Q1
2563,tt2952692,stateofplay,87,"Documentary,Drama,Sport",6.5,2009-04-17,60000000,37017955,88832210,125850165,65850165,2009,April,4,spring,Q2
745,tt1430612,brickmansions,90,"Action,Crime",5.7,2014-04-25,28000000,20396829,73421224,93818053,65818053,2014,April,4,spring,Q2
398,tt1212450,lawless,116,"Crime,Drama",7.3,2012-08-29,26000000,37397291,54393687,91790978,65790978,2012,August,8,summer,Q3
1533,tt1781922,noescape,103,"Action,Thriller",6.8,2015-08-26,5000000,27288872,42844516,70133388,65133388,2015,August,8,summer,Q3
2256,tt2309260,thegallows,81,"Horror,Mystery,Thriller",4.2,2015-07-10,100000,22764410,41656474,64420884,64320884,2015,July,7,summer,Q3
63,tt0480687,hallpass,105,"Comedy,Romance",5.9,2011-02-25,68000000,45060734,87173475,132234209,64234209,2011,February,2,winter/holiday,Q1
1266,tt1650554,kickass2,103,"Action,Comedy,Crime",6.6,2013-08-16,28000000,28795985,63129909,91925894,63925894,2013,August,8,summer,Q3
2571,tt2978462,dolphintale2,107,"Drama,Family",6.4,2014-09-12,36000000,42024533,57824533,99849066,63849066,2014,September,9,Fall,Q3
661,tt1385867,copout,107,"Action,Comedy,Crime",5.6,2010-02-26,37000000,44875481,55909910,100785391,63785391,2010,February,2,winter/holiday,Q1
2559,tt2938956,thetransporterrefueled,96,"Action,Adventure,Crime",5.2,2015-09-04,22000000,16029670,69698495,85728165,63728165,2015,September,9,Fall,Q3
776,tt1441951,quartet,94,"Comedy,Drama",6.8,2013-01-11,11000000,18388357,56178935,74567292,63567292,2013,January,1,winter/holiday,Q1
585,tt1322269,augustosagecounty,121,"Comedy,Drama",7.2,2013-12-25,25000000,37738810,50738810,88477620,63477620,2013,December,12,winter/holiday,Q4
126,tt0850709,risen,121,"Biography,Drama",5.3,2016-02-19,20000000,36880033,46255763,83135796,63135796,2016,February,2,winter/holiday,Q1
1991,tt2193215,thecounselor,117,"Crime,Drama,Thriller",5.3,2013-10-25,25000000,16973715,71009334,87983049,62983049,2013,October,10,Fall,Q4
50,tt0472399,themechanic,93,"Action,Crime,Thriller",6.6,2011-01-28,42500000,29121498,76347393,105468891,62968891,2011,January,1,winter/holiday,Q1
3156,tt6802308,the1517toparis,94,"Biography,Drama,Thriller",5.2,2018-02-09,30000000,36276286,56096200,92372486,62372486,2018,February,2,winter/holiday,Q1
3157,tt6850820,peppermint,101,"Action,Crime,Drama",6.5,2018-09-07,25000000,35418723,51800758,87219481,62219481,2018,September,9,Fall,Q3
2436,tt2609912,kevinhartletmeexplain,75,"Comedy,Documentary",6.8,2013-07-03,2500000,32244051,32327255,64571306,62071306,2013,July,7,summer,Q3
1093,tt1572315,texaschainsaw3d,92,"Horror,Thriller",4.8,2013-01-04,20000000,34341945,47666013,82007958,62007958,2013,January,1,winter/holiday,Q1
371,tt1210047,snatched,107,"Comedy,Crime,Mystery",5.9,2017-05-12,42000000,45852178,57852177,103704355,61704355,2017,May,5,spring,Q2
903,tt1488555,thechangeup,112,"Comedy,Fantasy",6.3,2011-08-05,52000000,37243418,75997067,113240485,61240485,2011,August,8,summer,Q3
104,tt0815236,shesoutofmyleague,104,"Comedy,Romance",6.4,2010-03-12,20000000,32010860,48680977,80691837,60691837,2010,March,3,spring,Q1
1027,tt1542344,127hours,94,"Adventure,Biography,Drama",7.6,2010-11-05,18000000,18335230,60217171,78552401,60552401,2010,November,11,Fall,Q4
193,tt0985694,machete,105,"Action,Crime,Thriller",6.6,2010-09-03,12500000,26593646,46370970,72964616,60464616,2010,September,9,Fall,Q3
359,tt1195478,thefiveyearengagement,124,"Comedy,Romance",6.2,2012-04-27,30000000,28700285,61623819,90324104,60324104,2012,April,4,spring,Q2
2150,tt2229499,donjon,90,"Comedy,Drama,Romance",6.6,2013-09-27,5500000,24477704,41268579,65746283,60246283,2013,September,9,Fall,Q3
7,tt0365907,awalkamongthetombstones,114,"Action,Crime,Drama",6.5,2014-09-19,28000000,26017685,62108587,88126272,60126272,2014,September,9,Fall,Q3
1289,tt1661382,grudgematch,113,"Comedy,Drama,Sport",6.4,2013-12-25,40000000,29807260,69807260,99614520,59614520,2013,December,12,winter/holiday,Q4
704,tt1403981,rememberme,113,"Drama,Romance",7.1,2010-03-12,16000000,19068240,56506120,75574360,59574360,2010,March,3,spring,Q1
1813,tt1991245,chernobyldiaries,86,"Horror,Mystery,Thriller",5.0,2012-05-25,1000000,18119640,42411721,60531361,59531361,2012,May,5,spring,Q2
2549,tt2918436,thelazaruseffect,83,"Horror,Mystery,Sci-Fi",5.2,2015-02-27,5000000,25801570,38359310,64160880,59160880,2015,February,2,winter/holiday,Q1
389,tt1211956,escapeplan,115,"Action,Crime,Mystery",6.7,2013-10-18,70000000,25135965,103735965,128871930,58871930,2013,October,10,Fall,Q4
2757,tt3480796,vice,96,"Action,Adventure,Sci-Fi",4.2,2018-12-25,60000000,47836282,70883171,118719453,58719453,2018,December,12,winter/holiday,Q4
343,tt1178665,awalkinthewoods,104,"Adventure,Biography,Comedy",6.3,2015-09-02,8000000,29499394,37119358,66618752,58618752,2015,September,9,Fall,Q3
140,tt0889573,theswitch,101,"Comedy,Drama,Romance",6.1,2010-08-20,19000000,27758465,49858465,77616930,58616930,2010,August,8,summer,Q3
856,tt1458175,thenextthreedays,133,"Action,Crime,Drama",7.4,2010-11-19,30000000,21148651,67255916,88404567,58404567,2010,November,11,Fall,Q4
2531,tt2870612,asabovesobelow,93,"Adventure,Horror,Mystery",6.2,2014-08-29,5000000,21222315,41824066,63046381,58046381,2014,August,8,summer,Q3
1063,tt1563738,oneday,107,"Drama,Romance",7.0,2011-08-19,15000000,13843771,59168692,73012463,58012463,2011,August,8,summer,Q3
1414,tt1728973,thefamily,88,"Horror,Thriller",5.0,2013-09-13,30000000,36918811,51078541,87997352,57997352,2013,September,9,Fall,Q3
418,tt1226753,thedebt,113,"Drama,Thriller",6.9,2011-08-31,20000000,31177548,46604054,77781602,57781602,2011,August,8,summer,Q3
904,tt1488602,theforest,98,"Horror,Thriller",3.5,2016-01-08,10000000,26594261,40749230,67343491,57343491,2016,January,1,winter/holiday,Q1
641,tt1371111,cloudatlas,172,"Action,Drama,Mystery",7.4,2012-10-26,102000000,27108272,130673154,157781426,55781426,2012,October,10,Fall,Q4
642,tt1371150,thisiswhereileaveyou,103,"Comedy,Drama",6.6,2014-09-19,20000000,34296320,41296320,75592640,55592640,2014,September,9,Fall,Q3
1866,tt2058673,pointbreak,114,"Action,Crime,Sport",5.3,2015-12-25,100000000,28782481,126704591,155487072,55487072,2015,December,12,winter/holiday,Q4
2668,tt3316960,stillalice,101,Drama,7.5,2015-01-16,5000000,18656400,41699612,60356012,55356012,2015,January,1,winter/holiday,Q1
87,tt0780653,thewolfman,103,"Drama,Fantasy,Horror",5.8,2010-02-12,150000000,62189884,142634358,204824242,54824242,2010,February,2,winter/holiday,Q1
1298,tt1666185,alleyezonme,139,"Biography,Drama,Music",5.8,2017-06-16,45000000,44922302,54876855,99799157,54799157,2017,June,6,summer,Q2
2828,tt3727750,gifted,104,Documentary,7.0,2017-04-07,7000000,24801212,36964656,61765868,54765868,2017,April,4,spring,Q2
706,tt1405500,forcoloredgirls,133,Drama,6.1,2010-11-05,21000000,37729698,38017873,75747571,54747571,2010,November,11,Fall,Q4
2908,tt4136084,florencefosterjenkins,111,"Biography,Comedy,Drama",6.8,2016-08-12,29000000,27383770,56000339,83384109,54384109,2016,August,8,summer,Q3
3137,tt6306064,adrift,96,"Action,Adventure,Biography",6.6,2018-06-01,35000000,31445011,57897191,89342202,54342202,2018,June,6,summer,Q2
401,tt1213663,theworldsend,109,"Action,Comedy,Sci-Fi",7.0,2013-08-23,20000000,26004851,47508505,73513356,53513356,2013,August,8,summer,Q3
1578,tt1817273,theplacebeyondthepines,140,"Crime,Drama,Thriller",7.3,2013-03-29,15000000,21403519,47011449,68414968,53414968,2013,March,3,spring,Q1
2805,tt3640424,allied,124,"Action,Drama,Romance",7.1,2016-11-23,106000000,40098064,119266661,159364725,53364725,2016,November,11,Fall,Q4
115,tt0822847,priest,87,"Action,Adventure,Fantasy",5.7,2011-05-13,60000000,29136626,84154026,113290652,53290652,2011,May,5,spring,Q2
121,tt0842926,thekidsareallright,106,"Comedy,Drama,Romance",7.0,2010-07-09,4000000,20811365,36275469,57086834,53086834,2010,July,7,summer,Q3
1377,tt1706620,snowpiercer,126,"Action,Drama,Sci-Fi",7.1,2014-06-27,40000000,4563029,88069880,92632909,52632909,2014,June,6,summer,Q2
318,tt1137450,deathwish,107,"Action,Crime,Drama",6.4,2018-03-02,30000000,34017028,48575965,82592993,52592993,2018,March,3,spring,Q1
2430,tt2582782,hellorhighwater,102,"Action,Crime,Drama",7.6,2016-08-12,12000000,27007844,37584304,64592148,52592148,2016,August,8,summer,Q3
1736,tt1921064,pompeii,105,"Action,Adventure,Drama",5.5,2014-02-21,80000000,23169033,108469033,131638066,51638066,2014,February,2,winter/holiday,Q1
3115,tt5734576,thepossessionofhannahgrace,86,"Horror,Mystery,Thriller",5.2,2018-11-30,6000000,14836174,42785387,57621561,51621561,2018,November,11,Fall,Q4
188,tt0978764,suckerpunch,110,"Action,Adventure,Fantasy",6.1,2011-03-25,75000000,36392502,89758389,126150891,51150891,2011,March,3,spring,Q1
2413,tt2554274,crimsonpeak,119,"Drama,Fantasy,Horror",6.5,2015-10-16,55000000,31090320,74966854,106057174,51057174,2015,October,10,Fall,Q4
307,tt1126618,morningglory,107,"Comedy,Drama,Romance",6.5,2010-11-10,40000000,31011732,59795070,90806802,50806802,2010,November,11,Fall,Q4
47,tt0470752,exmachina,108,"Drama,Mystery,Sci-Fi",7.7,2015-04-10,13000000,25440971,38358392,63799363,50799363,2015,April,4,spring,Q2
1549,tt1798709,her,126,"Drama,Romance,Sci-Fi",8.0,2014-01-10,23000000,25568251,48163815,73732066,50732066,2014,January,1,winter/holiday,Q1
1253,tt1647668,milliondollararm,124,"Biography,Drama,Sport",7.0,2014-05-16,25000000,36447959,39217912,75665871,50665871,2014,May,5,spring,Q2
2227,tt2279339,lovethecoopers,107,"Comedy,Fantasy,Romance",5.8,2015-11-13,18000000,26302731,42227490,68530221,50530221,2015,November,11,Fall,Q4
669,tt1389139,whentheboughbreaks,107,"Crime,Drama,Horror",5.1,2016-09-09,10000000,29747603,30768449,60516052,50516052,2016,September,9,Fall,Q3
1181,tt1617661,jupiterascending,127,"Action,Adventure,Sci-Fi",5.3,2015-02-06,179000000,47482519,181982519,229465038,50465038,2015,February,2,winter/holiday,Q1
1193,tt1622547,30minutesorless,83,"Action,Comedy,Crime",6.1,2011-08-12,28000000,37053924,40966716,78020640,50020640,2011,August,8,summer,Q3
2803,tt3623726,rickiandtheflash,101,"Comedy,Drama,Music",5.9,2015-08-07,18000000,26839498,41166033,68005531,50005531,2015,August,8,summer,Q3
2240,tt2296697,concussion,96,Drama,5.7,2015-12-25,35000000,34531832,50363790,84895622,49895622,2015,December,12,winter/holiday,Q4
2263,tt2312718,homefront,100,"Action,Thriller",6.5,2013-11-27,22000000,20158492,51695362,71853854,49853854,2013,November,11,Fall,Q4
2302,tt2364841,runnerrunner,88,"Crime,Thriller",5.6,2013-10-04,30000000,19316646,60512680,79829326,49829326,2013,October,10,Fall,Q4
1022,tt1540011,blairwitch,89,"Horror,Mystery,Thriller",5.0,2016-09-16,10000000,20777061,38985577,59762638,49762638,2016,September,9,Fall,Q3
284,tt1093357,thedarkesthour,89,"Action,Adventure,Horror",4.9,2011-12-25,34800000,21443494,62831715,84275209,49475209,2011,December,12,winter/holiday,Q4
530,tt1285009,thestrangerspreyatnight,85,Horror,5.2,2018-03-09,5000000,24431472,29960051,54391523,49391523,2018,March,3,spring,Q1
1942,tt2121286,homeagain,104,Drama,6.6,2017-09-08,15000000,27020284,37336874,64357158,49357158,2017,September,9,Fall,Q3
1098,tt1578275,thedilemma,111,"Comedy,Drama",5.3,2011-01-14,70000000,48475290,70546865,119022155,49022155,2011,January,1,winter/holiday,Q1
3023,tt4799050,roughnight,101,"Comedy,Crime,Thriller",5.2,2017-06-16,20000000,22105643,46844357,68950000,48950000,2017,June,6,summer,Q2
330,tt1152398,beastly,86,"Drama,Fantasy,Romance",5.6,2011-03-04,17000000,27865571,38028230,65893801,48893801,2011,March,3,spring,Q1
1315,tt1674771,entourage,104,Comedy,6.6,2015-06-03,30000000,32363404,46438538,78801942,48801942,2015,June,6,summer,Q2
2431,tt2582802,whiplash,106,"Drama,Music",8.5,2014-10-10,3300000,13092006,38969037,52061043,48761043,2014,October,10,Fall,Q4
2585,tt3042592,brothers,104,Action,5.1,2009-12-04,26000000,28544157,45043870,73588027,47588027,2009,December,12,winter/holiday,Q4
2733,tt3401882,fistfight,91,Comedy,5.6,2017-02-17,25000000,32187017,40286416,72473433,47473433,2017,February,2,winter/holiday,Q1
1595,tt1828325,thegambler,105,Drama,7.0,2014-12-10,25000000,33680992,38718031,72399023,47399023,2014,December,12,winter/holiday,Q4
1021,tt1538403,themortalinstrumentscityofbones,130,"Action,Fantasy,Horror",5.9,2013-08-21,60000000,31165421,75965567,107130988,47130988,2013,August,8,summer,Q3
847,tt1449283,winniethepooh,63,"Adventure,Animation,Comedy",7.2,2011-07-15,30000000,26692846,50145607,76838453,46838453,2011,July,7,summer,Q3
434,tt1230204,sammysavonturendegeheimedoorgang,88,"Adventure,Animation,Family",6.1,2010-12-31,25000000,0,71594792,71594792,46594792,2010,December,12,winter/holiday,Q4
553,tt1298649,thewatch,102,"Action,Comedy,Horror",5.7,2012-07-27,55000000,34353000,67130045,101483045,46483045,2012,July,7,summer,Q3
2826,tt3722070,theladyinthevan,104,"Biography,Comedy,Drama",6.7,2016-01-15,6000000,10021175,42320503,52341678,46341678,2016,January,1,winter/holiday,Q1
2881,tt4030600,thebyebyeman,96,"Drama,Fantasy,Horror",4.3,2017-01-13,7400000,22395806,31187727,53583533,46183533,2017,January,1,winter/holiday,Q1
2013,tt2215719,katyperrypartofme,93,"Documentary,Music",5.9,2012-07-05,12000000,25326071,32700439,58026510,46026510,2012,July,7,summer,Q3
2848,tt3799694,theniceguys,116,"Action,Comedy,Crime",7.4,2016-05-20,50000000,36261763,59596747,95858510,45858510,2016,May,5,spring,Q2
2761,tt3486626,thenutjob2nuttybynature,91,"Adventure,Animation,Comedy",5.5,2017-08-11,40000000,28370522,57438389,85808911,45808911,2017,August,8,summer,Q3
1228,tt1637706,ouridiotbrother,90,"Comedy,Drama",6.4,2011-08-26,5000000,24814830,25861249,50676079,45676079,2011,August,8,summer,Q3
2172,tt2247476,whenthegamestandstall,115,"Drama,Family,Sport",6.7,2014-08-22,15000000,30127963,30138912,60266875,45266875,2014,August,8,summer,Q3
2566,tt2967224,hotpursuit,87,"Action,Comedy,Crime",5.1,2015-05-08,35000000,34580201,45671512,80251713,45251713,2015,May,5,spring,Q2
1108,tt1588337,deshommesetdesdieux,122,"Drama,History",7.2,2011-02-25,5000000,3954651,46263525,50218176,45218176,2011,February,2,winter/holiday,Q1
2501,tt2752758,devilsdue,89,"Horror,Mystery,Thriller",4.1,2014-01-17,7000000,15821461,36146087,51967548,44967548,2014,January,1,winter/holiday,Q1
2347,tt2402157,thenovemberman,108,"Action,Crime,Thriller",6.3,2014-08-27,15000000,25018119,34820335,59838454,44838454,2014,August,8,summer,Q3
2974,tt4572514,patriotsday,133,"Action,Crime,Drama",7.4,2016-12-21,40000000,31886361,52837989,84724350,44724350,2016,December,12,winter/holiday,Q4
231,tt10300662,kidnap,104,Drama,7.5,2017-08-04,21000000,30718107,34836080,65554187,44554187,2017,August,8,summer,Q3
1655,tt1853739,yourenext,95,"Action,Comedy,Horror",6.6,2013-08-23,1000000,18494006,26887177,45381183,44381183,2013,August,8,summer,Q3
2017,tt2224026,home,94,"Adventure,Animation,Comedy",6.6,2009-04-23,500000,15433,44793168,44808601,44308601,2009,April,4,spring,Q2
639,tt1366344,thesitter,81,Comedy,5.7,2011-12-09,25000000,30542576,38749404,69291980,44291980,2011,December,12,winter/holiday,Q4
2348,tt2402927,carol,118,"Drama,Romance",7.2,2015-11-20,11800000,12711491,42843521,55555012,43755012,2015,November,11,Fall,Q4
1994,tt2199571,runallnight,114,"Action,Drama,Thriller",6.6,2015-03-13,50000000,26461644,66961644,93423288,43423288,2015,March,3,spring,Q1
1405,tt1727388,thewaywayback,103,"Comedy,Drama",7.4,2013-07-05,5000000,21502690,26853810,48356500,43356500,2013,July,7,summer,Q3
2370,tt2436386,projectalmanac,106,"Drama,Mystery,Sci-Fi",6.4,2015-01-30,12000000,22348241,32909437,55257678,43257678,2015,January,1,winter/holiday,Q1
2511,tt2786328,thecircle,48,"Adventure,Documentary,History",7.6,2017-04-28,18000000,20497844,40651864,61149708,43149708,2017,April,4,spring,Q2
1748,tt1935179,mud,130,Drama,7.4,2013-04-26,10000000,21590086,31556959,53147045,43147045,2013,April,4,spring,Q2
519,tt1273678,thespynextdoor,94,"Action,Comedy,Family",5.5,2010-01-15,28000000,24307106,46752858,71059964,43059964,2010,January,1,winter/holiday,Q1
3081,tt5439796,loganlucky,118,"Comedy,Crime,Drama",7.0,2017-08-18,29000000,27778642,44264271,72042913,43042913,2017,August,8,summer,Q3
254,tt1067774,montecarlo,109,"Adventure,Comedy,Family",5.8,2011-07-01,20000000,23186769,39686769,62873538,42873538,2011,July,7,summer,Q3
3000,tt4669788,onthebasisofsex,120,"Biography,Drama",6.9,2018-12-25,20000000,24622687,38073377,62696064,42696064,2018,December,12,winter/holiday,Q4
66,tt0485985,redtails,125,"Action,Adventure,Drama",5.9,2012-01-20,58000000,49876377,50365498,100241875,42241875,2012,January,1,winter/holiday,Q1
1853,tt2039338,flatliners,109,"Drama,Horror,Mystery",5.2,2017-09-29,20000000,16883115,45173738,62056853,42056853,2017,September,9,Fall,Q3
1791,tt1972779,thebestofme,118,"Drama,Romance",6.7,2014-10-17,26000000,26766213,41059418,67825631,41825631,2014,October,10,Fall,Q4
3090,tt5580266,thehateugive,133,"Crime,Drama",7.3,2018-10-05,23000000,29719483,35067665,64787148,41787148,2018,October,10,Fall,Q4
1968,tt2172934,3daystokill,117,"Action,Drama,Thriller",6.2,2014-02-21,28000000,30697999,38959900,69657899,41657899,2014,February,2,winter/holiday,Q1
2321,tt2387433,darkskies,97,"Horror,Sci-Fi,Thriller",6.3,2013-02-22,3500000,17418667,27704111,45122778,41622778,2013,February,2,winter/holiday,Q1
1774,tt1961175,americanassassin,112,"Action,Thriller",6.2,2017-09-15,63000000,36249674,68310140,104559814,41559814,2017,September,9,Fall,Q3
1184,tt1619029,jackie,100,"Biography,Drama,History",6.7,2016-12-02,9000000,13960394,36588512,50548906,41548906,2016,December,12,winter/holiday,Q4
2290,tt2357129,jobs,128,"Biography,Drama",5.9,2013-08-16,18000000,16131410,43402515,59533925,41533925,2013,August,8,summer,Q3
1864,tt2057392,eyeinthesky,102,"Drama,Thriller,War",7.3,2016-03-11,13000000,18704596,35402802,54107398,41107398,2016,March,3,spring,Q1
970,tt1517260,thehost,125,"Action,Adventure,Drama",5.9,2013-03-29,50000000,26623701,64477051,91100752,41100752,2013,March,3,spring,Q1
601,tt1334512,arthur,110,"Comedy,Romance",5.7,2011-04-08,40000000,33035397,47787943,80823340,40823340,2011,April,4,spring,Q2
1922,tt2101441,springbreakers,94,"Comedy,Crime,Drama",5.3,2013-03-15,5000000,14124286,31149251,45273537,40273537,2013,March,3,spring,Q1
58,tt0478304,thetreeoflife,139,"Drama,Fantasy",6.8,2011-05-27,35000000,13305665,61721826,75027491,40027491,2011,May,5,spring,Q2
2767,tt3521126,thedisasterartist,104,"Biography,Comedy,Drama",7.4,2017-12-01,10000000,21120616,28717667,49838283,39838283,2017,December,12,winter/holiday,Q4
404,tt1216492,leapyear,100,"Comedy,Romance",6.5,2010-01-08,19000000,25918920,32618920,58537840,39537840,2010,January,1,winter/holiday,Q1
2510,tt2784678,topfive,102,"Comedy,Romance",6.4,2014-12-12,12000000,25317379,26001741,51319120,39319120,2014,December,12,winter/holiday,Q4
1508,tt1772240,apollo18,86,"Horror,Mystery,Sci-Fi",5.2,2011-09-02,5000000,17686929,26517819,44204748,39204748,2011,September,9,Fall,Q3
1502,tt1764234,killingthemsoftly,97,"Crime,Thriller",6.2,2012-11-30,15000000,14945541,39238443,54183984,39183984,2012,November,11,Fall,Q4
1698,tt1876451,sparkle,116,"Drama,Music",5.7,2012-08-17,10000000,24397469,24660323,49057792,39057792,2012,August,8,summer,Q3
1269,tt1655420,myweekwithmarilyn,99,"Biography,Drama",7.0,2011-11-23,10000000,14597405,34240572,48837977,38837977,2011,November,11,Fall,Q4
77,tt0493949,ramonaandbeezus,103,"Adventure,Comedy,Family",6.6,2010-07-23,15000000,26167002,27469621,53636623,38636623,2010,July,7,summer,Q3
730,tt1414382,youagain,105,"Comedy,Family,Romance",5.8,2010-09-24,20000000,25702053,32838945,58540998,38540998,2010,September,9,Fall,Q3
1347,tt1694020,theguilttrip,95,"Comedy,Drama",5.8,2012-12-19,40000000,37134215,41294674,78428889,38428889,2012,December,12,winter/holiday,Q4
1789,tt1972571,amostwantedman,122,"Crime,Drama,Thriller",6.8,2014-07-25,15000000,17237855,36068890,53306745,38306745,2014,July,7,summer,Q3
1039,tt1555069,maryqueenofscots,119,"Biography,Drama,History",5.5,2018-12-07,25000000,16468499,46734733,63203232,38203232,2018,December,12,winter/holiday,Q4
507,tt1270761,dontbeafraidofthedark,99,"Fantasy,Horror,Thriller",5.6,2011-08-26,25000000,24046682,39126427,63173109,38173109,2011,August,8,summer,Q3
2265,tt2318092,endlesslove,104,"Drama,Romance",6.3,2014-02-14,20000000,23438250,34718173,58156423,38156423,2014,February,2,winter/holiday,Q1
3172,tt7388562,paulapostleofchrist,108,"Adventure,Biography,Drama",6.7,2018-03-23,5000000,17547999,25529498,43077497,38077497,2018,March,3,spring,Q1
2621,tt3170832,room,118,"Drama,Thriller",8.2,2015-10-16,13000000,14677674,36262783,50940457,37940457,2015,October,10,Fall,Q4
352,tt1188996,mynameiskhan,165,Drama,8.0,2010-02-12,8470000,4046336,42355526,46401862,37931862,2010,February,2,winter/holiday,Q1
1672,tt1867035,race,150,Drama,3.9,2016-02-19,5000000,19115191,23745772,42860963,37860963,2016,February,2,winter/holiday,Q1
264,tt1083452,eddietheeagle,106,"Biography,Comedy,Drama",7.4,2016-02-26,23000000,15789389,45060480,60849869,37849869,2016,February,2,winter/holiday,Q1
1286,tt1659337,theperksofbeingawallflower,103,Drama,8.0,2012-09-21,13000000,17742948,33069303,50812251,37812251,2012,September,9,Fall,Q3
1746,tt1931435,thebigwedding,89,"Comedy,Drama,Romance",5.6,2013-04-26,32500000,21819348,48425971,70245319,37745319,2013,April,4,spring,Q2
437,tt1232200,thatsmyboy,116,Comedy,5.6,2012-06-15,57500000,36931089,58085235,95016324,37516324,2012,June,6,summer,Q2
2999,tt4669186,kevinhartwhatnow,96,"Comedy,Documentary",5.9,2016-10-14,10000000,23591043,23591043,47182086,37182086,2016,October,10,Fall,Q4
1959,tt2159988,thewalk,89,"Crime,Thriller",6.8,2015-09-30,35000000,10161183,61492104,71653287,36653287,2015,September,9,Fall,Q3
1848,tt2034139,thelastexorcismpartii,88,"Drama,Horror,Thriller",4.0,2013-03-01,4000000,15179303,25448707,40628010,36628010,2013,March,3,spring,Q1
2686,tt3332064,pan,111,"Adventure,Comedy,Family",5.8,2015-10-09,150000000,35088320,151525973,186614293,36614293,2015,October,10,Fall,Q4
320,tt1139328,theghostwriter,128,"Drama,Mystery,Thriller",7.2,2010-02-19,45000000,15541549,65532491,81074040,36074040,2010,February,2,winter/holiday,Q1
341,tt1171222,baggageclaim,96,Comedy,5.1,2013-09-27,8500000,21569509,22885836,44455345,35955345,2013,September,9,Fall,Q3
2641,tt3235888,itfollows,100,"Horror,Mystery",6.9,2015-03-13,2000000,14674077,23250755,37924832,35924832,2015,March,3,spring,Q1
768,tt1438254,charliestcloud,99,"Drama,Fantasy,Romance",6.5,2010-07-30,44000000,31206263,48478084,79684347,35684347,2010,July,7,summer,Q3
1854,tt2042568,insidellewyndavis,104,"Drama,Music",7.5,2013-12-06,11000000,13248209,32943247,46191456,35191456,2013,December,12,winter/holiday,Q4
2337,tt2390361,enoughsaid,93,"Comedy,Drama,Romance",7.0,2013-09-18,8000000,17550872,25621449,43172321,35172321,2013,September,9,Fall,Q3
757,tt1433108,faster,98,"Action,Crime,Drama",6.5,2010-11-24,24000000,23240020,35792945,59032965,35032965,2010,November,11,Fall,Q4
1529,tt1781769,annakarenina,129,"Drama,Romance",6.6,2012-11-16,49000000,12816367,71004627,83820994,34820994,2012,November,11,Fall,Q4
3041,tt4981636,middleschooltheworstyearsofmylife,92,"Comedy,Family",6.1,2016-10-07,8500000,20007149,23311293,43318442,34818442,2016,October,10,Fall,Q4
1379,tt1710396,joyfulnoise,118,"Comedy,Drama,Music",5.8,2012-01-13,27500000,30932113,31157914,62090027,34590027,2012,January,1,winter/holiday,Q1
1747,tt1931533,sevenpsychopaths,110,"Comedy,Crime",7.2,2012-10-12,13500000,15024049,33035736,48059785,34559785,2012,October,10,Fall,Q4
2539,tt2883434,blackorwhite,121,Drama,6.6,2015-01-30,9000000,21571189,21971021,43542210,34542210,2015,January,1,winter/holiday,Q1
2523,tt2828996,ahauntedhouse2,86,"Comedy,Fantasy",4.7,2014-04-18,4000000,17329487,21206861,38536348,34536348,2014,April,4,spring,Q2
3126,tt6003368,diaryofawimpykidthelonghaul,91,"Comedy,Family",4.4,2017-05-19,22000000,20738724,35609577,56348301,34348301,2017,May,5,spring,Q2
1945,tt2125435,beastsofthesouthernwild,93,"Adventure,Drama,Fantasy",7.3,2012-06-27,1800000,12795746,23265132,36060878,34260878,2012,June,6,summer,Q2
1160,tt1608290,zoolander2,101,Comedy,4.7,2016-02-12,50000000,28848693,55348693,84197386,34197386,2016,February,2,winter/holiday,Q1
1950,tt2139881,longshot,125,"Comedy,Romance",7.2,2019-05-03,40000000,30202860,43711031,73913891,33913891,2019,May,5,spring,Q2
2381,tt2473602,getonup,139,"Biography,Drama,Music",6.9,2014-08-01,30000000,30569935,33339868,63909803,33909803,2014,August,8,summer,Q3
1142,tt1602620,amour,127,"Drama,Romance",7.9,2012-12-19,9700000,6738954,36787044,43525998,33825998,2012,December,12,winter/holiday,Q4
2014,tt2223990,draftday,110,"Drama,Sport",6.8,2014-04-11,25000000,28842237,29847480,58689717,33689717,2014,April,4,spring,Q2
237,tt1034389,theeagle,114,"Action,Adventure,Drama",6.2,2011-02-11,25000000,19490041,38993548,58483589,33483589,2011,February,2,winter/holiday,Q1
156,tt0947810,greenzone,115,"Action,Drama,Thriller",6.8,2010-03-12,100000000,35497337,97523020,133020357,33020357,2010,March,3,spring,Q1
1476,tt1741273,secretintheireyes,111,"Crime,Drama,Mystery",6.3,2015-11-20,20000000,20180155,32608019,52788174,32788174,2015,November,11,Fall,Q4
2274,tt2334649,fruitvalestation,85,"Biography,Drama,Romance",7.5,2013-07-12,900000,16098998,17549645,33648643,32748643,2013,July,7,summer,Q3
3107,tt5688932,sorrytobotheryou,111,"Comedy,Fantasy,Sci-Fi",7.0,2018-07-06,3200000,17493096,18285560,35778656,32578656,2018,July,7,summer,Q3
190,tt0979434,lotteryticket,99,Comedy,5.0,2010-08-20,17000000,24719879,24719879,49439758,32439758,2010,August,8,summer,Q3
929,tt1506999,haywire,93,"Action,Drama,Thriller",5.8,2012-01-20,23000000,18942396,36374700,55317096,32317096,2012,January,1,winter/holiday,Q1
303,tt1126590,bigeyes,106,"Biography,Crime,Drama",7.0,2014-12-25,10000000,14482031,27317872,41799903,31799903,2014,December,12,winter/holiday,Q4
1501,tt1764183,arbitrage,107,"Drama,Thriller",6.6,2012-09-14,12000000,7919574,35830713,43750287,31750287,2012,September,9,Fall,Q3
299,tt1121096,seventhson,102,"Action,Adventure,Fantasy",5.5,2015-02-06,95000000,17725785,108874967,126600752,31600752,2015,February,2,winter/holiday,Q1
708,tt1407061,justwright,100,"Comedy,Romance,Sport",5.9,2010-05-14,12000000,21540363,21867665,43408028,31408028,2010,May,5,spring,Q2
1724,tt1904996,parker,118,"Action,Crime,Thriller",6.2,2013-01-25,35000000,17616641,48543388,66160029,31160029,2013,January,1,winter/holiday,Q1
487,tt1255919,holmeswatson,90,"Adventure,Comedy,Crime",3.8,2018-12-25,42000000,30568743,41926605,72495348,30495348,2018,December,12,winter/holiday,Q4
2391,tt2503944,burnt,101,"Comedy,Drama",6.6,2015-10-30,20000000,13651946,36773510,50425456,30425456,2015,October,10,Fall,Q4
1581,tt1821549,nebraska,115,"Adventure,Comedy,Drama",7.7,2013-11-15,12000000,17654912,24761360,42416272,30416272,2013,November,11,Fall,Q4
1034,tt1549920,thelaststand,107,"Action,Thriller",6.4,2013-01-18,30000000,12050299,48330757,60381056,30381056,2013,January,1,winter/holiday,Q1
2680,tt3330566,mother,64,"Documentary,Drama,Fantasy",7.8,2017-09-15,30000000,17800004,42531076,60331080,30331080,2017,September,9,Fall,Q3
599,tt1333125,movie43,94,Comedy,4.3,2013-01-25,10000000,8840453,31164747,40005200,30005200,2013,January,1,winter/holiday,Q1
2354,tt2404233,godsofegypt,127,"Action,Adventure,Fantasy",5.4,2016-02-26,140000000,31153464,138836756,169990220,29990220,2016,February,2,winter/holiday,Q1
2001,tt2205401,addicted,106,"Drama,Thriller",5.2,2014-10-10,5000000,17390770,17499242,34890012,29890012,2014,October,10,Fall,Q4
1055,tt1559547,beautifulcreatures,124,"Drama,Fantasy,Romance",6.2,2013-02-14,50000000,19452138,60282876,79735014,29735014,2013,February,2,winter/holiday,Q1
1119,tt1594972,normofthenorth,90,"Adventure,Animation,Comedy",3.6,2016-01-15,18000000,17062499,30535660,47598159,29598159,2016,January,1,winter/holiday,Q1
607,tt1336608,rockofages,123,"Comedy,Drama,Musical",5.9,2012-06-15,70000000,38518613,61031932,99550545,29550545,2012,June,6,summer,Q2
587,tt1322312,goingthedistance,102,"Comedy,Romance",6.3,2010-09-03,32000000,17804299,43603990,61408289,29408289,2010,September,9,Fall,Q3
1056,tt1560747,themaster,138,Drama,7.1,2012-09-14,37500000,16247159,50647416,66894575,29394575,2012,September,9,Fall,Q3
2904,tt4103724,forevermygirl,108,"Drama,Music,Romance",6.7,2018-01-19,3500000,16376066,16376066,32752132,29252132,2018,January,1,winter/holiday,Q1
767,tt1438176,frightnight,106,"Comedy,Horror",6.4,2011-08-19,30000000,18298649,40520649,58819298,28819298,2011,August,8,summer,Q3
2998,tt4667094,fiftyshadesofblack,92,Comedy,3.5,2016-01-29,5000000,11686940,22113075,33800015,28800015,2016,January,1,winter/holiday,Q1
3006,tt4695012,itcomesatnight,91,"Horror,Mystery",6.2,2017-06-09,5000000,13985117,19720203,33705320,28705320,2017,June,6,summer,Q2
2861,tt3850214,dope,103,"Comedy,Crime,Drama",7.2,2015-06-19,7000000,17506470,18190831,35697301,28697301,2015,June,6,summer,Q2
733,tt1418377,ifrankenstein,92,"Action,Fantasy,Horror",5.1,2014-01-24,65000000,19075290,74575290,93650580,28650580,2014,January,1,winter/holiday,Q1
61,tt0480255,thelosers,97,"Action,Adventure,Crime",6.4,2010-04-23,25000000,23591432,29863840,53455272,28455272,2010,April,4,spring,Q2
2003,tt2209418,beforemidnight,109,"Drama,Romance",7.9,2013-05-24,3000000,8110621,23251930,31362551,28362551,2013,May,5,spring,Q2
1116,tt1592525,lockout,95,"Action,Sci-Fi,Thriller",6.1,2012-04-13,20000000,14326865,33943049,48269914,28269914,2012,April,4,spring,Q2
2841,tt3766394,hellomynameisdoris,90,"Comedy,Drama,Romance",6.6,2016-03-11,1000000,14444999,14662703,29107702,28107702,2016,March,3,spring,Q1
1666,tt1860357,deepwaterhorizon,107,"Action,Drama,History",7.1,2016-09-30,156000000,61433527,122603824,184037351,28037351,2016,September,9,Fall,Q3
445,tt1234719,reddawn,93,"Action,Sci-Fi,Thriller",5.4,2012-11-21,65000000,44806783,48164150,92970933,27970933,2012,November,11,Fall,Q4
558,tt1305583,ourfamilywedding,103,"Comedy,Romance",4.9,2010-03-12,14000000,20255281,21410546,41665827,27665827,2010,March,3,spring,Q1
1506,tt1767382,silenthouse,86,"Drama,Horror,Mystery",5.3,2012-03-09,2000000,12739737,16610760,29350497,27350497,2012,March,3,spring,Q1
1201,tt1625346,youngadult,94,"Comedy,Drama",6.3,2011-12-09,12000000,16311571,22750356,39061927,27061927,2011,December,12,winter/holiday,Q4
3007,tt4698684,huntforthewilderpeople,101,"Adventure,Comedy,Drama",7.9,2016-06-24,2500000,5205471,23845533,29051004,26551004,2016,June,6,summer,Q2
2503,tt2763304,t2trainspotting,117,Drama,7.2,2017-03-17,18000000,2402004,42091262,44493266,26493266,2017,March,3,spring,Q1
1381,tt1712170,alexcross,101,"Action,Crime,Mystery",5.1,2012-10-19,35000000,25888412,35426759,61315171,26315171,2012,October,10,Fall,Q4
2909,tt4139124,keanu,100,"Action,Comedy,Crime",6.3,2016-04-29,15000000,20591853,20688141,41279994,26279994,2016,April,4,spring,Q2
1074,tt1568338,manonaledge,102,"Action,Adventure,Crime",6.6,2012-01-27,42000000,18620000,49621440,68241440,26241440,2012,January,1,winter/holiday,Q1
1344,tt1691916,beforeifall,98,"Drama,Fantasy,Mystery",6.4,2017-03-03,5000000,12241072,18945682,31186754,26186754,2017,March,3,spring,Q1
1995,tt2202408,transcendence,98,Drama,6.1,2014-04-18,100000000,23022309,103039258,126061567,26061567,2014,April,4,spring,Q2
3160,tt7014006,eighthgrade,93,"Comedy,Drama",7.5,2018-07-13,2000000,13539710,14341016,27880726,25880726,2018,July,7,summer,Q3
206,tt10075374,thelittleprince,93,Action,8.3,2016-02-12,77500000,1311213,102028919,103340132,25840132,2016,February,2,winter/holiday,Q1
1038,tt1555064,countrystrong,117,"Drama,Music",6.3,2010-12-22,15000000,20218921,20601987,40820908,25820908,2010,December,12,winter/holiday,Q4
3077,tt5322012,wishupon,90,"Drama,Fantasy,Horror",5.0,2017-07-14,12000000,14301505,23477345,37778850,25778850,2017,July,7,summer,Q3
1276,tt1656190,safe,94,"Action,Crime,Thriller",6.5,2012-04-27,33000000,17142080,41495213,58637293,25637293,2012,April,4,spring,Q2
3150,tt6499752,upgrade,100,"Action,Sci-Fi,Thriller",7.6,2018-06-01,3000000,11977130,16553285,28530415,25530415,2018,June,6,summer,Q2
297,tt1120985,bluevalentine,112,"Drama,Romance",7.4,2010-12-29,1000000,9737892,16566240,26304132,25304132,2010,December,12,winter/holiday,Q4
3176,tt7690670,superfly,116,"Action,Crime,Thriller",5.0,2018-06-13,16000000,20537137,20723581,41260718,25260718,2018,June,6,summer,Q2
344,tt1179034,frompariswithlove,92,"Action,Crime,Thriller",6.5,2010-02-05,52000000,24077427,53139168,77216595,25216595,2010,February,2,winter/holiday,Q1
2887,tt4056738,doyoubelieve,120,Drama,6.1,2015-03-20,2300000,12985600,14304931,27290531,24990531,2015,March,3,spring,Q1
2599,tt3077214,suffragette,106,"Biography,Drama,History",6.9,2015-10-23,14000000,4702420,34044909,38747329,24747329,2015,October,10,Fall,Q4
1702,tt1878870,theedgeofseventeen,104,"Comedy,Drama",7.3,2016-11-18,9000000,14431633,19096003,33527636,24527636,2016,November,11,Fall,Q4
2597,tt3072482,hardcorehenry,96,"Action,Adventure,Sci-Fi",6.7,2016-04-08,2000000,9252038,17187434,26439472,24439472,2016,April,4,spring,Q2
1410,tt1728200,thebox,89,Drama,6.3,2009-11-06,25000000,15051977,34356760,49408737,24408737,2009,November,11,Fall,Q4
3015,tt4761916,unfriendeddarkweb,92,"Crime,Horror,Mystery",5.9,2018-07-20,1000000,8866745,16434588,25301333,24301333,2018,July,7,summer,Q3
81,tt0770703,whatsyournumber,106,"Comedy,Romance",6.1,2011-09-30,20000000,14011084,30163785,44174869,24174869,2011,September,9,Fall,Q3
1576,tt1814621,admission,107,"Comedy,Drama,Romance",5.7,2013-03-22,13000000,18007317,18733666,36740983,23740983,2013,March,3,spring,Q1
1818,tt1999890,hellfest,89,Horror,5.5,2018-09-28,5500000,11107431,18119231,29226662,23726662,2018,September,9,Fall,Q3
1908,tt2083383,troublewiththecurve,111,"Drama,Sport",6.8,2012-09-21,60000000,35763137,47818913,83582050,23582050,2012,September,9,Fall,Q3
1905,tt2080374,stevejobs,122,"Biography,Drama",7.2,2015-10-09,30000000,17766658,35579007,53345665,23345665,2015,October,10,Fall,Q4
2442,tt2638144,benhur,123,"Action,Adventure,Drama",5.7,2016-08-19,95000000,26410477,91669648,118080125,23080125,2016,August,8,summer,Q3
1187,tt1620449,konferenzdertiere,93,"Adventure,Animation,Comedy",4.9,2010-12-31,30000000,0,53048539,53048539,23048539,2010,December,12,winter/holiday,Q4
3162,tt7125860,ifbealestreetcouldtalk,119,"Drama,Romance",7.2,2018-12-14,12000000,14915773,19859167,34774940,22774940,2018,December,12,winter/holiday,Q4
2926,tt4196450,thebirthofanation,120,"Biography,Drama,History",6.4,2016-10-07,10000000,15861566,16891011,32752577,22752577,2016,October,10,Fall,Q4
2752,tt3464902,thelobster,119,"Comedy,Drama,Romance",7.1,2016-03-25,4500000,9196278,18019834,27216112,22716112,2016,March,3,spring,Q1
489,tt1258972,themanwiththeironfists,95,Action,5.4,2012-11-02,15000000,15634090,22018988,37653078,22653078,2012,November,11,Fall,Q4
350,tt1182350,youwillmeetatalldarkstranger,98,"Comedy,Drama,Romance",6.3,2010-09-22,15000000,3247816,34247816,37495632,22495632,2010,September,9,Fall,Q3
1168,tt1615147,margincall,107,"Drama,Thriller",7.1,2011-10-21,3400000,5353586,20433227,25786813,22386813,2011,October,10,Fall,Q4
2609,tt3125324,beyondthelights,116,"Drama,Music,Romance",6.9,2014-11-14,7000000,14618727,14618727,29237454,22237454,2014,November,11,Fall,Q4
2942,tt4276820,thefounder,115,"Biography,Drama,History",7.2,2017-01-20,15000000,12786053,24403192,37189245,22189245,2017,January,1,winter/holiday,Q1
2581,tt3014866,criminal,113,"Action,Crime,Drama",6.3,2016-04-15,31500000,14708696,38771262,53479958,21979958,2016,April,4,spring,Q2
75,tt0492389,furryvengeance,92,"Comedy,Family",3.8,2010-04-30,35000000,17630465,39340177,56970642,21970642,2010,April,4,spring,Q2
1628,tt1840417,thewords,102,"Drama,Mystery,Romance",7.1,2012-09-07,6000000,11494838,16369708,27864546,21864546,2012,September,9,Fall,Q3
2516,tt2798920,annihilation,115,"Adventure,Drama,Horror",6.9,2018-02-23,55000000,32732301,43070915,75803216,20803216,2018,February,2,winter/holiday,Q1
690,tt1399683,wintersbone,100,"Drama,Mystery",7.2,2010-06-11,2000000,6531503,16131551,22663054,20663054,2010,June,6,summer,Q2
1129,tt1598828,oneforthemoney,91,"Action,Comedy,Crime",5.3,2012-01-27,42000000,26414527,36197221,62611748,20611748,2012,January,1,winter/holiday,Q1
898,tt1486192,theraven,110,"Crime,Mystery,Thriller",6.4,2012-04-27,26000000,16008272,30601801,46610073,20610073,2012,April,4,spring,Q2
2969,tt4550098,nocturnalanimals,116,"Drama,Thriller",7.5,2016-11-18,22500000,10663357,32398681,43062038,20562038,2016,November,11,Fall,Q4
1025,tt1540133,theguard,96,"Comedy,Crime,Thriller",7.3,2011-07-29,6000000,5359774,21197454,26557228,20557228,2011,July,7,summer,Q3
846,tt1448755,killerelite,116,"Action,Crime,Thriller",6.5,2011-09-23,70000000,25124986,65409046,90534032,20534032,2011,September,9,Fall,Q3
3166,tt7153766,unsane,98,"Drama,Horror,Mystery",6.4,2018-03-23,1500000,7690044,14244931,21934975,20434975,2018,March,3,spring,Q1
2292,tt2358891,lagrandebellezza,141,Drama,7.8,2013-11-15,12000000,2883879,29549145,32433024,20433024,2013,November,11,Fall,Q4
425,tt1228987,letmein,116,"Drama,Fantasy,Horror",7.1,2010-10-01,20000000,12134935,28270399,40405334,20405334,2010,October,10,Fall,Q4
866,tt1462758,buried,95,"Drama,Mystery,Thriller",7.0,2010-09-24,1987650,1044143,21270290,22314433,20326783,2010,September,9,Fall,Q3
2965,tt4537896,whiteboyrick,111,"Crime,Drama",6.4,2018-09-14,30000000,24004833,25947983,49952816,19952816,2018,September,9,Fall,Q3
1953,tt2140379,selfless,117,"Action,Mystery,Sci-Fi",6.5,2015-07-10,26000000,12279691,33667319,45947010,19947010,2015,July,7,summer,Q3
2697,tt3381068,legend,94,Horror,3.5,2015-11-20,25000000,1872994,42425450,44298444,19298444,2015,November,11,Fall,Q4
450,tt1235522,brokencity,109,"Crime,Drama,Thriller",6.2,2013-01-18,35000000,19701164,34480045,54181209,19181209,2013,January,1,winter/holiday,Q1
2350,tt2403021,thegreeninferno,100,"Adventure,Horror",5.3,2015-09-25,1000000,7192291,12931420,20123711,19123711,2015,September,9,Fall,Q3
2165,tt2243377,leftbehind,86,"Horror,Mystery,Thriller",6.5,2014-10-03,16000000,14019924,20769209,34789133,18789133,2014,October,10,Fall,Q4
1308,tt1668200,ellesappelaitsarah,111,"Drama,War",7.5,2011-07-22,14500000,7691700,25480031,33171731,18671731,2011,July,7,summer,Q3
1382,tt1712261,triple9,115,"Crime,Thriller",6.3,2016-02-26,20000000,12639297,25943792,38583089,18583089,2016,February,2,winter/holiday,Q1
90,tt0790628,theincredibleburtwonderstone,100,"Adventure,Comedy,Fantasy",5.9,2013-03-15,32000000,22537881,27392609,49930490,17930490,2013,March,3,spring,Q1
1399,tt1723811,shame,101,Drama,7.2,2011-12-02,6500000,4002293,20412841,24415134,17915134,2011,December,12,winter/holiday,Q4
1701,tt1878841,thedarkness,92,"Horror,Thriller",4.4,2016-05-13,4000000,10753574,10898293,21651867,17651867,2016,May,5,spring,Q2
1001,tt1529567,searex3djourneytoaprehistoricworld,41,Documentary,6.9,2010-05-28,5000000,6096582,16515203,22611785,17611785,2010,May,5,spring,Q2
2916,tt4191580,meettheblacks,94,"Comedy,Horror",5.9,2016-04-01,900000,9097072,9097072,18194144,17294144,2016,April,4,spring,Q2
1137,tt1600196,thedrop,106,"Crime,Drama",7.1,2014-09-12,12600000,10724389,19054534,29778923,17178923,2014,September,9,Fall,Q3
2894,tt4073790,thedarkestminds,104,"Action,Adventure,Drama",5.7,2018-08-03,34000000,12695691,38361428,51057119,17057119,2018,August,8,summer,Q3
263,tt1082807,thebelkoexperiment,89,"Horror,Thriller",6.1,2017-03-17,5000000,10166820,11792942,21959762,16959762,2017,March,3,spring,Q1
1006,tt1532503,beginners,105,"Comedy,Drama,Romance",7.2,2011-06-03,3200000,5790894,14314407,20105301,16905301,2011,June,6,summer,Q2
76,tt0493405,chips,100,"Action,Comedy,Crime",6.0,2017-03-24,25000000,18600152,23190292,41790444,16790444,2017,March,3,spring,Q1
1775,tt1961562,thehouse,109,"Drama,Mystery,Thriller",4.6,2017-06-30,40000000,25584504,31192425,56776929,16776929,2017,June,6,summer,Q2
2667,tt3316948,americanultra,96,"Action,Comedy,Sci-Fi",6.1,2015-08-21,28000000,14439985,30295028,44735013,16735013,2015,August,8,summer,Q3
1032,tt1547234,premiumrush,91,"Action,Crime,Thriller",6.5,2012-08-24,35000000,20275446,31393201,51668647,16668647,2012,August,8,summer,Q3
160,tt0955308,robinhood,140,"Action,Adventure,Drama",6.6,2018-11-21,99000000,30824628,84747441,115572069,16572069,2018,November,11,Fall,Q4
1427,tt1731998,ida,104,Thriller,6.1,2014-05-02,2600000,3827060,15298355,19125415,16525415,2014,May,5,spring,Q2
1671,tt1866249,thesessions,95,"Biography,Comedy,Drama",7.2,2012-10-19,1000000,6002451,11495204,17497655,16497655,2012,October,10,Fall,Q4
1166,tt1614989,hodejegerne,96,"Action,Crime,Thriller",7.6,2012-04-27,5250000,1200010,20188740,21388750,16138750,2012,April,4,spring,Q2
2799,tt3612616,mommy,139,Drama,8.1,2015-01-23,4900000,3498695,17536004,21034699,16134699,2015,January,1,winter/holiday,Q1
488,tt1255953,incendies,131,"Drama,Mystery,War",8.3,2010-09-17,6800000,6857096,16038343,22895439,16095439,2010,September,9,Fall,Q3
2914,tt4183692,woodlawn,123,"Drama,Sport",6.5,2015-10-16,13000000,14394097,14403703,28797800,15797800,2015,October,10,Fall,Q4
3117,tt5804038,iamnotyournegro,93,Documentary,7.8,2017-02-03,1000000,7123919,9617402,16741321,15741321,2017,February,2,winter/holiday,Q1
1346,tt1692486,carnage,80,"Comedy,Drama",7.2,2011-12-16,25000000,2546747,38112154,40658901,15658901,2011,December,12,winter/holiday,Q4
1826,tt2006295,the33,127,"Biography,Drama,History",6.9,2015-11-13,25000000,12227722,28400715,40628437,15628437,2015,November,11,Fall,Q4
474,tt1247436,unforgettable,88,Documentary,5.9,2017-04-21,12000000,11368012,16221211,27589223,15589223,2017,April,4,spring,Q2
1926,tt2106476,jagten,115,Drama,8.3,2013-05-17,3450000,687185,18309793,18996978,15546978,2013,May,5,spring,Q2
1545,tt1792647,cirquedusoleilworldsaway,91,Fantasy,6.8,2012-12-21,25000000,12512862,28012862,40525724,15525724,2012,December,12,winter/holiday,Q4
987,tt1527186,melancholia,135,"Drama,Sci-Fi",7.2,2011-11-11,9400000,3030848,21817298,24848146,15448146,2011,November,11,Fall,Q4
1727,tt1911600,missbala,113,"Crime,Drama,Thriller",6.5,2019-02-01,15000000,14998027,15362298,30360325,15360325,2019,February,2,winter/holiday,Q1
756,tt1431181,anotheryear,129,"Comedy,Drama",7.3,2010-12-29,8000000,3205706,20005613,23211319,15211319,2010,December,12,winter/holiday,Q4
3105,tt5649144,thefloridaproject,111,Drama,7.6,2017-10-06,2000000,5904366,11295324,17199690,15199690,2017,October,10,Fall,Q4
2538,tt2879218,thecollector,94,"Action,Comedy",7.1,2009-07-31,3000000,7712114,10473836,18185950,15185950,2009,July,7,summer,Q3
2383,tt2473794,mrturner,150,"Biography,Drama,History",6.8,2014-12-19,14000000,3958546,25187026,29145572,15145572,2014,December,12,winter/holiday,Q4
1543,tt1791682,whilewereyoung,97,"Comedy,Drama,Mystery",6.3,2015-03-27,10000000,7582065,17503828,25085893,15085893,2015,March,3,spring,Q1
2378,tt2465146,andsoitgoes,94,"Comedy,Drama,Romance",5.8,2014-07-25,18000000,15160801,17920013,33080814,15080814,2014,July,7,summer,Q3
606,tt1335975,47ronin,128,"Action,Adventure,Drama",6.3,2013-12-25,175000000,38362475,151716815,190079290,15079290,2013,December,12,winter/holiday,Q4
3154,tt6628394,badtimesattheelroyale,141,"Crime,Drama,Mystery",7.1,2018-10-12,32000000,17839115,29204379,47043494,15043494,2018,October,10,Fall,Q4
1498,tt1758810,thesnowman,119,"Crime,Drama,Mystery",5.1,2017-10-20,35000000,6670765,43226146,49896911,14896911,2017,October,10,Fall,Q4
3033,tt4871980,theperfectmatch,96,"Comedy,Romance",4.9,2016-03-11,5000000,9669521,10182050,19851571,14851571,2016,March,3,spring,Q1
2411,tt2547584,thelightbetweenoceans,133,"Drama,Romance",7.2,2016-09-02,20000000,12545979,22281732,34827711,14827711,2016,September,9,Fall,Q3
671,tt1390411,intheheartofthesea,122,"Action,Adventure,Biography",6.9,2015-12-11,100000000,25020758,89693309,114714067,14714067,2015,December,12,winter/holiday,Q4
1817,tt1999192,kevinhartlaughatmypain,89,"Comedy,Documentary",7.4,2011-09-09,750000,7706436,7712436,15418872,14668872,2011,September,9,Fall,Q3
902,tt1488181,zambezia,83,"Adventure,Animation,Comedy",5.8,2012-12-31,20000000,0,34454336,34454336,14454336,2012,December,12,winter/holiday,Q4
1290,tt1661420,polisse,127,"Crime,Drama",7.3,2012-05-18,8900000,176988,22744132,22921120,14021120,2012,May,5,spring,Q2
1314,tt1673697,thesapphires,103,"Biography,Comedy,Drama",7.0,2013-03-22,9000000,2450867,20395040,22845907,13845907,2013,March,3,spring,Q1
2473,tt2670524,youth,107,Drama,6.1,2015-12-04,13000000,2703296,24001573,26704869,13704869,2015,December,12,winter/holiday,Q4
1779,tt1966359,fatherfigures,113,"Adventure,Comedy,Drama",5.5,2017-12-22,25000000,17501244,21038441,38539685,13539685,2017,December,12,winter/holiday,Q4
2784,tt3553442,whiskeytangofoxtrot,112,"Biography,Comedy,Drama",6.6,2016-03-04,35000000,23083334,25350747,48434081,13434081,2016,March,3,spring,Q1
1373,tt1704573,bernie,99,"Biography,Comedy,Crime",6.8,2012-04-27,6000000,9204489,10106975,19311464,13311464,2012,April,4,spring,Q2
864,tt1462041,dreamhouse,84,"Drama,Mystery,Thriller",6.0,2011-09-30,50000000,21302340,41642166,62944506,12944506,2011,September,9,Fall,Q3
1143,tt1604171,prom,104,"Comedy,Drama,Family",5.4,2011-04-29,8000000,10130219,10763183,20893402,12893402,2011,April,4,spring,Q2
539,tt1291584,warrior,140,"Drama,Sport",8.2,2011-09-09,25000000,13657115,24215385,37872500,12872500,2011,September,9,Fall,Q3
2577,tt3007512,thewaterdiviner,111,"Drama,History,War",7.1,2015-04-24,22500000,4200117,31054727,35254844,12754844,2015,April,4,spring,Q2
1221,tt1633356,sharknight3d,90,"Horror,Thriller",4.0,2011-09-02,25000000,18877153,18877153,37754306,12754306,2011,September,9,Fall,Q3
3146,tt6421110,proudmary,89,"Action,Crime,Drama",4.9,2018-01-12,30000000,20868638,21709539,42578177,12578177,2018,January,1,winter/holiday,Q1
2283,tt2347569,francesha,86,"Comedy,Drama,Romance",7.4,2013-05-17,3000000,4067398,11262769,15330167,12330167,2013,May,5,spring,Q2
1869,tt2063008,theroad,110,"Crime,Drama,Horror",5.6,2009-11-25,25000000,8114270,29206732,37321002,12321002,2009,November,11,Fall,Q4
1723,tt1899353,serbuanmaut,101,"Action,Thriller",7.6,2012-03-23,1100000,4105123,9297407,13402530,12302530,2012,March,3,spring,Q1
1223,tt1634003,metegol,106,"Adventure,Animation,Family",6.5,2013-12-31,22000000,0,34061097,34061097,12061097,2013,December,12,winter/holiday,Q4
735,tt1421051,somewhere,97,"Comedy,Drama",6.3,2010-12-22,7000000,1785645,17023121,18808766,11808766,2010,December,12,winter/holiday,Q4
2847,tt3787590,weareyourfriends,96,"Drama,Music,Romance",6.2,2015-08-28,2000000,3591417,10153415,13744832,11744832,2015,August,8,summer,Q3
3001,tt4669986,loving,123,"Biography,Drama,Romance",7.0,2016-11-04,9000000,7710234,12898064,20608298,11608298,2016,November,11,Fall,Q4
3118,tt5804314,lettherebelight,100,Drama,4.8,2017-10-27,3000000,7233471,7241309,14474780,11474780,2017,October,10,Fall,Q4
636,tt1366338,lowriders,98,"Adventure,Crime,Drama",5.7,2017-05-12,916000,6179955,6188421,12368376,11452376,2017,May,5,spring,Q2
1383,tt1714206,thespectacularnow,95,"Comedy,Drama,Romance",7.1,2013-08-02,2500000,6852971,6916951,13769922,11269922,2013,August,8,summer,Q3
2441,tt2637294,hottubtimemachine2,93,"Comedy,Mystery,Sci-Fi",5.1,2015-02-20,14000000,12314651,12826644,25141295,11141295,2015,February,2,winter/holiday,Q1
666,tt1389072,downsizing,135,"Drama,Sci-Fi",5.7,2017-12-22,68000000,24449754,54462971,78912725,10912725,2017,December,12,winter/holiday,Q4
2787,tt3566920,theothersideofthedoor,90,Drama,3.8,2016-03-04,5000000,3000342,12905107,15905449,10905449,2016,March,3,spring,Q1
2980,tt4595882,canyoueverforgiveme,106,"Biography,Comedy,Crime",7.2,2018-10-19,10000000,8803865,11752387,20556252,10556252,2018,October,10,Fall,Q4
597,tt1327709,cyrus,87,"Crime,Horror,Mystery",4.7,2010-06-18,7000000,7468936,10062896,17531832,10531832,2010,June,6,summer,Q2
1865,tt2058107,therailwayman,116,"Biography,Drama,Romance",7.1,2014-04-11,18000000,4438438,23910210,28348648,10348648,2014,April,4,spring,Q2
1481,tt1742650,idontknowhowshedoesit,89,"Comedy,Romance",4.9,2011-09-16,24000000,9659074,24474463,34133537,10133537,2011,September,9,Fall,Q3
1245,tt1645089,insidejob,109,"Crime,Documentary",8.3,2010-10-08,2000000,4311834,7799257,12111091,10111091,2010,October,10,Fall,Q4
1092,tt1571249,theskeletontwins,93,"Comedy,Drama,Romance",6.8,2014-09-12,1000000,5284309,5797192,11081501,10081501,2014,September,9,Fall,Q3
1734,tt1920849,bachelorette,87,"Comedy,Romance",5.3,2012-09-07,3000000,446770,12577401,13024171,10024171,2012,September,9,Fall,Q3
616,tt1343727,dredd,95,"Action,Crime,Sci-Fi",7.1,2012-09-21,45000000,13414714,41467606,54882320,9882320,2012,September,9,Fall,Q3
2849,tt3808342,saulfia,107,"Drama,War",7.5,2015-12-18,1700000,1777043,9696537,11473580,9773580,2015,December,12,winter/holiday,Q4
707,tt1405810,minevaganti,110,"Comedy,Drama,Romance",7.3,2010-12-31,9100000,0,18872126,18872126,9772126,2010,December,12,winter/holiday,Q4
1397,tt1720182,octoberbaby,107,Drama,6.8,2012-03-23,1000000,5355847,5391992,10747839,9747839,2012,March,3,spring,Q1
2997,tt4663548,allsaints,108,Drama,6.0,2017-08-25,2000000,5802208,5941994,11744202,9744202,2017,August,8,summer,Q3
364,tt1198101,kites,123,"Action,Drama,Romance",6.1,2010-05-21,9200000,1685269,17155193,18840462,9640462,2010,May,5,spring,Q2
1783,tt1967545,laborday,111,"Drama,Romance",6.9,2014-01-31,18000000,13371528,14189810,27561338,9561338,2014,January,1,winter/holiday,Q1
1962,tt2166214,khiladi786,141,"Action,Comedy",4.4,2012-12-07,5600000,385422,14683763,15069185,9469185,2012,December,12,winter/holiday,Q4
2797,tt3606888,astreetcatnamedbob,103,"Biography,Comedy,Drama",7.4,2016-11-18,8000000,82703,17382693,17465396,9465396,2016,November,11,Fall,Q4
459,tt1243974,aloha,105,"Comedy,Drama,Romance",5.4,2015-05-29,37000000,21052030,25387091,46439121,9439121,2015,May,5,spring,Q2
2638,tt3216348,incarnate,91,"Horror,Thriller",5.3,2016-12-02,5000000,4799774,9371036,14170810,9170810,2016,December,12,winter/holiday,Q4
640,tt1366365,thecoldlightofday,93,"Action,Thriller",4.9,2012-09-07,20000000,3763583,25361206,29124789,9124789,2012,September,9,Fall,Q3
1394,tt1716777,peoplelikeus,114,"Comedy,Drama",7.1,2012-06-29,16000000,12431792,12617472,25049264,9049264,2012,June,6,summer,Q2
233,tt10300710,hitrun,114,"Action,Comedy",7.1,2012-08-22,22000000,13749300,17216955,30966255,8966255,2012,August,8,summer,Q3
1273,tt1655460,wanderlust,98,"Comedy,Romance",5.6,2012-02-24,32500000,17288155,24159934,41448089,8948089,2012,February,2,winter/holiday,Q1
292,tt1111235,trance,83,Horror,4.6,2013-04-05,16000000,2322593,22594052,24916645,8916645,2013,April,4,spring,Q2
563,tt1307068,seekingafriendfortheendoftheworld,101,"Adventure,Comedy,Drama",6.7,2012-06-22,10000000,7078738,11766959,18845697,8845697,2012,June,6,summer,Q2
643,tt1371155,madeindagenham,113,"Biography,Comedy,Drama",7.2,2010-11-19,8000000,1095369,15644196,16739565,8739565,2010,November,11,Fall,Q4
960,tt1508675,lehavre,93,"Comedy,Drama",7.2,2011-10-21,5500000,611709,13480196,14091905,8591905,2011,October,10,Fall,Q4
2158,tt2235108,dearwhitepeople,108,"Comedy,Drama,Romance",6.1,2014-10-17,1250000,4404154,5403771,9807925,8557925,2014,October,10,Fall,Q4
1365,tt1702425,casademipadre,84,"Comedy,Western",5.5,2012-03-16,6000000,5909483,8446952,14356435,8356435,2012,March,3,spring,Q1
2428,tt2582500,shutin,91,"Drama,Mystery,Thriller",4.7,2016-11-11,10000000,6900335,11360665,18261000,8261000,2016,November,11,Fall,Q4
3073,tt5301662,marshall,118,"Biography,Crime,Drama",7.2,2017-10-13,12000000,10051659,10116816,20168475,8168475,2017,October,10,Fall,Q4
1837,tt2017038,allislost,106,"Action,Adventure,Drama",6.9,2013-10-18,8500000,6263670,10386814,16650484,8150484,2013,October,10,Fall,Q4
2427,tt2582496,meandearlandthedyinggirl,105,"Comedy,Drama,Romance",7.8,2015-06-12,8000000,6758416,9266180,16024596,8024596,2015,June,6,summer,Q2
3181,tt8632862,fahrenheit119,128,Documentary,6.7,2018-09-21,5000000,6352306,6653715,13006021,8006021,2018,September,9,Fall,Q3
3071,tt5247022,paterson,118,"Comedy,Drama,Romance",7.4,2016-12-28,5000000,2141423,10727536,12868959,7868959,2016,December,12,winter/holiday,Q4
244,tt1043726,thelegendofhercules,99,"Action,Adventure,Fantasy",4.2,2014-01-10,70000000,18848538,58953319,77801857,7801857,2014,January,1,winter/holiday,Q1
1669,tt1862079,safetynotguaranteed,86,"Comedy,Drama,Romance",7.0,2012-06-08,750000,4010957,4422318,8433275,7683275,2012,June,6,summer,Q2
2976,tt4573516,sleight,89,"Action,Drama,Sci-Fi",5.9,2017-04-28,250000,3930990,3934450,7865440,7615440,2017,April,4,spring,Q2
2694,tt3367294,compadres,101,"Action,Comedy,Crime",4.7,2016-04-22,3000000,3127773,7445044,10572817,7572817,2016,April,4,spring,Q2
1363,tt1699755,peeples,95,"Comedy,Romance",5.3,2013-05-10,11000000,9177065,9307166,18484231,7484231,2013,May,5,spring,Q2
773,tt1441326,marthamarcymaymarlene,102,"Drama,Mystery,Thriller",6.9,2011-10-21,1000000,2981038,5438911,8419949,7419949,2011,October,10,Fall,Q4
878,tt1470023,macgruber,90,"Action,Comedy,Romance",5.5,2010-05-21,10000000,8525600,8629895,17155495,7155495,2010,May,5,spring,Q2
2739,tt3416532,amonstercalls,108,"Animation,Drama,Fantasy",7.5,2017-01-06,43000000,3740823,46414530,50155353,7155353,2017,January,1,winter/holiday,Q1
2884,tt4034354,swissarmyman,97,"Adventure,Comedy,Drama",7.0,2016-06-24,3000000,4210454,5837111,10047565,7047565,2016,June,6,summer,Q2
2843,tt3774114,snowden,134,"Biography,Drama,Thriller",7.3,2016-09-16,50000000,21587519,35380918,56968437,6968437,2016,September,9,Fall,Q3
1496,tt1758692,likecrazy,86,"Drama,Romance",6.7,2011-10-28,250000,3395391,3728400,7123791,6873791,2011,October,10,Fall,Q4
1845,tt2025690,thefinesthours,117,"Action,Drama,History",6.8,2016-01-29,70000000,27569558,49252761,76822319,6822319,2016,January,1,winter/holiday,Q1
1026,tt1541995,snowflowerandthesecretfan,104,"Drama,History",6.1,2011-07-15,6000000,1348205,11348205,12696410,6696410,2011,July,7,summer,Q3
2964,tt4501454,themeddler,103,"Comedy,Drama,Romance",6.3,2016-04-22,3200000,4267219,5526942,9794161,6594161,2016,April,4,spring,Q2
1291,tt1663143,funsize,86,"Adventure,Comedy",5.4,2012-10-26,14000000,9409538,11166615,20576153,6576153,2012,October,10,Fall,Q4
146,tt0905372,thething,103,"Horror,Mystery,Sci-Fi",6.2,2011-10-14,38000000,16999934,27573078,44573012,6573012,2011,October,10,Fall,Q4
130,tt0872230,mysoultotake,107,"Horror,Mystery,Thriller",4.8,2010-10-08,25000000,14744435,16727470,31471905,6471905,2010,October,10,Fall,Q4
2268,tt2321549,thebabadook,94,"Drama,Horror",6.8,2014-11-28,2000000,950792,7482387,8433179,6433179,2014,November,11,Fall,Q4
432,tt1230168,samekindofdifferentasme,119,"Biography,Drama",6.5,2017-10-20,6500000,6423605,6423605,12847210,6347210,2017,October,10,Fall,Q4
1819,tt2002718,machetekills,107,"Action,Crime,Sci-Fi",5.6,2013-10-11,20000000,8008161,18273009,26281170,6281170,2013,October,10,Fall,Q4
89,tt0787524,themanwhoknewinfinity,108,"Biography,Drama",7.2,2016-04-29,10000000,3877922,12382122,16260044,6260044,2016,April,4,spring,Q2
461,tt1244754,conviction,107,"Biography,Crime,Drama",7.2,2010-10-15,12500000,6797696,11826980,18624676,6124676,2010,October,10,Fall,Q4
1497,tt1758795,thetodolist,104,"Comedy,Romance",5.8,2013-07-26,1500000,3491669,4128828,7620497,6120497,2013,July,7,summer,Q3
540,tt1291652,snabbacash,124,"Action,Crime,Drama",6.7,2012-07-11,4300000,188870,10212403,10401273,6101273,2012,July,7,summer,Q3
2984,tt4622512,battleofthesexes,121,"Biography,Comedy,Drama",6.7,2017-09-22,25000000,12638526,18445379,31083905,6083905,2017,September,9,Fall,Q3
901,tt1487931,khumba,85,"Adventure,Animation,Family",5.7,2013-12-06,15000000,0,20898221,20898221,5898221,2013,December,12,winter/holiday,Q4
1811,tt1990314,robotfrank,89,"Comedy,Crime,Drama",7.1,2012-08-17,2500000,3317468,4934356,8251824,5751824,2012,August,8,summer,Q3
1490,tt1748227,thecollection,82,"Action,Horror,Thriller",6.1,2012-11-30,10000000,6810754,8890094,15700848,5700848,2012,November,11,Fall,Q4
1964,tt2170299,badwords,89,"Comedy,Drama",6.7,2014-03-14,10000000,7779614,7843145,15622759,5622759,2014,March,3,spring,Q1
1007,tt1532958,battleoftheyear,110,"Drama,Music",5.1,2013-09-20,20000000,8888355,16723377,25611732,5611732,2013,September,9,Fall,Q3
132,tt0878835,pleasegive,87,"Comedy,Drama",6.6,2010-04-30,3000000,4033574,4570178,8603752,5603752,2010,April,4,spring,Q2
2586,tt3042592,brothers,104,Action,5.1,2015-08-14,13000000,656688,17856688,18513376,5513376,2015,August,8,summer,Q3
456,tt1242460,weneedtotalkaboutkevin,112,"Drama,Mystery,Thriller",7.5,2012-01-13,7000000,1738692,10765283,12503975,5503975,2012,January,1,winter/holiday,Q1
2543,tt2910274,obviouschild,84,"Comedy,Drama,Romance",6.8,2014-06-06,1000000,3122616,3324070,6446686,5446686,2014,June,6,summer,Q2
746,tt1430615,bigmiracle,107,"Biography,Drama,Family",6.5,2012-02-03,40000000,20157300,25268680,45425980,5425980,2012,February,2,winter/holiday,Q1
879,tt1470827,monsters,94,"Drama,Sci-Fi,Thriller",6.4,2010-10-29,500000,237301,5639730,5877031,5377031,2010,October,10,Fall,Q4
1251,tt1646974,lenomdesgens,100,"Comedy,Drama,Romance",7.2,2011-06-24,4600000,514237,9261711,9775948,5175948,2011,June,6,summer,Q2
2222,tt2277308,friendrequest,91,Thriller,4.0,2017-09-22,9900000,3759078,11310835,15069913,5169913,2017,September,9,Fall,Q3
575,tt1320291,thereef,94,"Adventure,Drama,Horror",5.8,2010-12-31,10000000,0,15037867,15037867,5037867,2010,December,12,winter/holiday,Q4
2878,tt3966404,mustang,97,Drama,7.6,2015-11-20,1400000,845464,5552584,6398048,4998048,2015,November,11,Fall,Q4
99,tt0804497,itskindofafunnystory,101,"Comedy,Drama,Romance",7.1,2010-10-08,8000000,6363628,6632950,12996578,4996578,2010,October,10,Fall,Q4
1912,tt2091473,promisedland,106,Drama,6.6,2013-01-04,15000000,7597898,12394562,19992460,4992460,2013,January,1,winter/holiday,Q1
566,tt1313092,animalkingdom,113,"Crime,Drama",7.3,2010-08-13,4200000,1044039,8078683,9122722,4922722,2010,August,8,summer,Q3
2852,tt3829920,onlythebrave,134,"Action,Biography,Drama",7.7,2017-10-20,38000000,18340051,24555177,42895228,4895228,2017,October,10,Fall,Q4
369,tt1206543,outofthefurnace,116,"Crime,Drama,Thriller",6.8,2013-12-04,22000000,11330849,15434375,26765224,4765224,2013,December,12,winter/holiday,Q4
885,tt1477837,cedarrapids,87,Comedy,6.3,2011-02-11,10000000,6861102,7862131,14723233,4723233,2011,February,2,winter/holiday,Q1
1028,tt1544600,thegracecard,101,Drama,6.6,2011-02-25,200000,2430735,2430735,4861470,4661470,2011,February,2,winter/holiday,Q1
82,tt0770802,samsara,102,"Documentary,Music",8.5,2012-08-24,4000000,2672413,5966671,8639084,4639084,2012,August,8,summer,Q3
2948,tt4337690,90minutesinheaven,121,Drama,4.8,2015-09-11,5000000,4816142,4816142,9632284,4632284,2015,September,9,Fall,Q3
1480,tt1742336,yoursisterssister,90,"Comedy,Drama",6.7,2012-06-15,120000,1597486,3090593,4688079,4568079,2012,June,6,summer,Q2
1674,tt1869425,fillybrown,80,"Drama,Music",5.7,2013-04-19,1250000,2850357,2940411,5790768,4540768,2013,April,4,spring,Q2
1309,tt1669617,homerun,82,"Drama,Family,Sport",4.2,2013-04-19,1200000,2859955,2859955,5719910,4519910,2013,April,4,spring,Q2
3122,tt5834262,hotelartemis,94,"Action,Drama,Sci-Fi",6.1,2018-06-08,15000000,6708137,12758799,19466936,4466936,2018,June,6,summer,Q2
3063,tt5147828,indivisible,78,Documentary,7.2,2018-10-26,2700000,3511417,3588305,7099722,4399722,2018,October,10,Fall,Q4
2793,tt3605418,knockknock,99,"Drama,Thriller",4.9,2015-10-09,2000000,36336,6328516,6364852,4364852,2015,October,10,Fall,Q4
1963,tt2167202,getaway,90,"Action,Crime,Thriller",4.4,2013-08-30,18000000,10501938,11813989,22315927,4315927,2013,August,8,summer,Q3
3133,tt6265828,aghoststory,92,"Drama,Fantasy,Romance",6.8,2017-07-07,100000,1594798,2769782,4364580,4264580,2017,July,7,summer,Q3
1406,tt1727776,scoutsguidetothezombieapocalypse,93,"Action,Comedy,Horror",6.3,2015-10-30,15000000,3703046,15554855,19257901,4257901,2015,October,10,Fall,Q4
1575,tt1810683,littleboy,106,"Drama,History,War",7.4,2015-04-24,20000000,6485961,17769299,24255260,4255260,2015,April,4,spring,Q2
2532,tt2870708,wishiwashere,106,"Comedy,Drama",6.7,2014-07-18,6000000,3591299,6591365,10182664,4182664,2014,July,7,summer,Q3
762,tt1437358,mientrasduermes,102,"Drama,Horror,Thriller",7.2,2012-10-26,5000000,0,9109597,9109597,4109597,2012,October,10,Fall,Q4
403,tt1216491,killthemessenger,112,"Biography,Crime,Drama",7.0,2014-10-10,5000000,2450846,6656705,9107551,4107551,2014,October,10,Fall,Q4
1510,tt1772288,dannycollins,106,"Biography,Comedy,Drama",7.0,2015-03-20,10000000,5637066,8465845,14102911,4102911,2015,March,3,spring,Q1
1140,tt1602098,albertnobbs,113,"Drama,Romance",6.7,2011-12-21,7500000,3014696,8539003,11553699,4053699,2011,December,12,winter/holiday,Q4
2949,tt4341582,queenofkatwe,124,"Biography,Drama,Sport",7.4,2016-09-23,15000000,8874389,10055481,18929870,3929870,2016,September,9,Fall,Q3
3127,tt6053438,firstreformed,113,"Drama,Mystery,Thriller",7.1,2018-05-18,3500000,3448256,3874772,7323028,3823028,2018,May,5,spring,Q2
1790,tt1972591,kingarthurlegendofthesword,126,"Action,Adventure,Drama",6.8,2017-05-12,175000000,39175066,139630336,178805402,3805402,2017,May,5,spring,Q2
981,tt1524575,thevaticantapes,91,"Horror,Thriller",5.0,2015-07-24,13000000,1784763,14929184,16713947,3713947,2015,July,7,summer,Q3
1073,tt1566501,forgreaterglorythetruestoryofcristiada,145,"Drama,History,War",6.6,2012-06-01,12000000,5669081,10026255,15695336,3695336,2012,June,6,summer,Q2
536,tt1289419,nsecure,105,"Crime,Drama,Thriller",3.6,2010-10-15,1600000,2595644,2595644,5191288,3591288,2010,October,10,Fall,Q4
3009,tt4701724,earlyman,89,"Adventure,Animation,Comedy",6.1,2018-02-16,50000000,8267544,45285890,53553434,3553434,2018,February,2,winter/holiday,Q1
128,tt0857190,thesweeney,112,"Action,Crime,Drama",6.1,2013-03-01,4500000,26345,8000366,8026711,3526711,2013,March,3,spring,Q1
2260,tt2309788,thegatekeepers,101,"Documentary,History,War",7.6,2013-02-01,1500000,2408553,2592308,5000861,3500861,2013,February,2,winter/holiday,Q1
122,tt0844993,hoodwinkedtoohoodvsevil,86,"Animation,Comedy,Crime",4.8,2011-04-29,30000000,10143779,23353111,33496890,3496890,2011,April,4,spring,Q2
149,tt0935075,rabbithole,91,Drama,7.0,2010-12-17,5000000,2229058,6205034,8434092,3434092,2010,December,12,winter/holiday,Q4
1351,tt1699745,captive,120,"Drama,Thriller",6.0,2015-09-18,2000000,2583301,2791973,5375274,3375274,2015,September,9,Fall,Q3
2989,tt4645330,denial,109,"Biography,Drama",6.7,2016-09-30,10000000,4073448,9263940,13337388,3337388,2016,September,9,Fall,Q3
2285,tt2349460,graceunplugged,102,"Drama,Music",6.2,2013-10-04,1700000,2507159,2507159,5014318,3314318,2013,October,10,Fall,Q4
852,tt1455256,thewall,78,Documentary,9.2,2017-05-12,3000000,1803064,4495262,6298326,3298326,2017,May,5,spring,Q2
1033,tt1549572,anotherearth,92,"Drama,Romance,Sci-Fi",7.0,2011-07-22,175000,1321194,2102779,3423973,3248973,2011,July,7,summer,Q3
719,tt1412528,table19,87,"Comedy,Drama,Romance",5.8,2017-03-03,5000000,3614896,4620399,8235295,3235295,2017,March,3,spring,Q1
1756,tt1943765,morgan,89,"Drama,Romance",6.8,2016-09-02,8000000,3915251,7298786,11214037,3214037,2016,September,9,Fall,Q3
2247,tt2304771,mandelalongwalktofreedom,141,"Biography,Drama,History",7.1,2013-11-29,35000000,8323085,29890402,38213487,3213487,2013,November,11,Fall,Q4
771,tt1440292,submarine,97,"Comedy,Drama,Romance",7.3,2011-06-03,1900000,467602,4581937,5049539,3149539,2011,June,6,summer,Q2
865,tt1462054,letterstogod,110,"Drama,Family",6.3,2010-04-09,3000000,2848587,3237452,6086039,3086039,2010,April,4,spring,Q2
3124,tt6000478,romanjisraelesq,122,"Crime,Drama,Thriller",6.4,2017-11-17,22000000,11962712,12967012,24929724,2929724,2017,November,11,Fall,Q4
1541,tt1791528,inherentvice,148,"Comedy,Crime,Drama",6.7,2014-12-12,20000000,8110975,14772346,22883321,2883321,2014,December,12,winter/holiday,Q4
3167,tt7158430,heartsbeatloud,97,"Comedy,Drama,Music",6.9,2018-06-08,2000000,2386254,2420962,4807216,2807216,2018,June,6,summer,Q2
3036,tt4902904,theresurrectionofgavinstone,91,"Comedy,Drama,Family",6.2,2017-01-20,2000000,2303792,2303792,4607584,2607584,2017,January,1,winter/holiday,Q1
1475,tt1740707,trolljegeren,103,"Drama,Fantasy,Horror",7.0,2011-06-10,3500000,253444,5706638,5960082,2460082,2011,June,6,summer,Q2
179,tt0968264,theconspirator,122,"Crime,Drama,History",6.9,2011-04-15,25000000,11538204,15907411,27445615,2445615,2011,April,4,spring,Q2
2835,tt3742378,quehoraselavolta,112,"Comedy,Drama",7.8,2015-08-28,1200000,376976,3249041,3626017,2426017,2015,August,8,summer,Q3
1241,tt1640711,afewbestmen,97,"Comedy,Romance",5.7,2015-05-05,15000000,0,17224539,17224539,2224539,2015,May,5,spring,Q2
648,tt1373405,theawakening,83,"Horror,Thriller",2.4,2012-08-17,4900000,95933,6924321,7020254,2120254,2012,August,8,summer,Q3
1,tt0326592,theovernight,88,,7.5,2015-06-19,200000,1109808,1165996,2275804,2075804,2015,June,6,summer,Q2
2890,tt4062536,greenroom,95,"Horror,Music,Thriller",7.0,2016-04-15,5000000,3220371,3807503,7027874,2027874,2016,April,4,spring,Q2
1530,tt1781784,burn,86,Documentary,7.5,2012-07-20,225000,1109276,1109276,2218552,1993552,2012,July,7,summer,Q3
1317,tt1675192,takeshelter,121,"Drama,Horror,Thriller",7.4,2011-09-30,4750000,1728953,4972016,6700969,1950969,2011,September,9,Fall,Q3
1385,tt1714210,weekend,97,"Drama,Romance",7.6,2011-09-23,190000,484592,1577585,2062177,1872177,2011,September,9,Fall,Q3
1814,tt1996264,foragoodtimecall,85,Comedy,6.0,2012-08-31,850000,1251749,1386088,2637837,1787837,2012,August,8,summer,Q3
923,tt1502404,driveangry,104,"Action,Fantasy,Thriller",5.4,2011-02-25,50000000,10721033,41042583,51763616,1763616,2011,February,2,winter/holiday,Q1
2623,tt3172532,thediaryofateenagegirl,102,"Comedy,Drama,Romance",6.9,2015-08-07,2000000,1477002,2279959,3756961,1756961,2015,August,8,summer,Q3
1328,tt1682180,stoker,99,"Drama,Thriller",6.8,2013-03-01,12000000,1703125,12034913,13738038,1738038,2013,March,3,spring,Q1
1629,tt1841642,demonic,83,"Horror,Thriller",5.3,2017-10-10,3000000,0,4668109,4668109,1668109,2017,October,10,Fall,Q4
2343,tt2401878,anomalisa,90,"Animation,Comedy,Drama",7.3,2015-12-30,8000000,3759286,5706168,9465454,1465454,2015,December,12,winter/holiday,Q4
2484,tt2692904,locke,85,Drama,7.1,2014-04-25,2000000,1370646,2088390,3459036,1459036,2014,April,4,spring,Q2
3067,tt5203734,columbus,127,Comedy,7.3,2017-08-04,700000,1017107,1110511,2127618,1427618,2017,August,8,summer,Q3
3134,tt6288250,patticake,109,"Drama,Music",6.7,2017-08-18,1000000,800148,1471090,2271238,1271238,2017,August,8,summer,Q3
3103,tt5649108,thoroughbreds,92,"Comedy,Crime,Drama",6.7,2018-03-09,5000000,3072605,3187302,6259907,1259907,2018,March,3,spring,Q1
1091,tt1571234,mortalengines,128,"Action,Adventure,Fantasy",6.1,2018-12-14,100000000,15951040,85287417,101238457,1238457,2018,December,12,winter/holiday,Q4
1426,tt1731697,thelordsofsalem,101,"Horror,Thriller",5.1,2013-04-19,1500000,1165881,1541131,2707012,1207012,2013,April,4,spring,Q2
2386,tt2479800,paloalto,100,Drama,6.2,2014-05-09,1000000,767732,1156309,1924041,924041,2014,May,5,spring,Q2
1788,tt1971352,compliance,90,"Biography,Crime,Drama",6.4,2012-08-17,270000,319285,830700,1149985,879985,2012,August,8,summer,Q3
1904,tt2076220,holymotors,115,"Drama,Fantasy",7.1,2012-10-17,4000000,641054,4230426,4871480,871480,2012,October,10,Fall,Q4
973,tt1518812,meekscutoff,104,"Drama,Western",6.6,2011-04-08,2000000,977772,1869928,2847700,847700,2011,April,4,spring,Q2
448,tt1235170,thefuture,91,"Drama,Fantasy,Romance",6.2,2011-07-29,1000000,568662,1239174,1807836,807836,2011,July,7,summer,Q3
2509,tt2771372,veronicamars,107,"Crime,Drama,Mystery",6.8,2014-03-14,6000000,3322127,3485383,6807510,807510,2014,March,3,spring,Q1
1401,tt1726592,beforeigotosleep,92,"Drama,Horror,Mystery",6.3,2014-10-31,22000000,3242457,19563579,22806036,806036,2014,October,10,Fall,Q4
2639,tt3230082,lachambrebleue,76,"Crime,Romance,Thriller",6.3,2014-10-03,1400000,260441,1945420,2205861,805861,2014,October,10,Fall,Q4
1089,tt1570989,tinyfurniture,98,"Comedy,Drama,Romance",6.2,2010-11-12,50000,391674,424149,815823,765823,2010,November,11,Fall,Q4
2601,tt3099498,tusk,102,"Comedy,Drama,Horror",5.3,2014-09-19,3000000,1821983,1887554,3709537,709537,2014,September,9,Fall,Q3
1489,tt1748207,soundofmyvoice,85,"Drama,Mystery,Sci-Fi",6.6,2012-04-27,135000,408015,429448,837463,702463,2012,April,4,spring,Q2
1005,tt1531663,everythingmustgo,97,"Comedy,Drama",6.4,2011-05-13,5000000,2712131,2821010,5533141,533141,2011,May,5,spring,Q2
1334,tt1684628,circumstance,107,Drama,5.9,2011-08-26,900000,454121,958978,1413099,513099,2011,August,8,summer,Q3
1090,tt1571222,adangerousmethod,99,"Biography,Drama,Romance",6.4,2011-11-23,20000000,5702083,14807531,20509614,509614,2011,November,11,Fall,Q4
1921,tt2101341,deadmandown,118,"Action,Crime,Drama",6.5,2013-03-08,30000000,10895295,19599974,30495269,495269,2013,March,3,spring,Q1
1141,tt1602613,onlygodforgives,90,"Crime,Drama",5.7,2013-07-19,4800000,775849,4494560,5270409,470409,2013,July,7,summer,Q3
1059,tt1560957,iwantyourmoney,92,Documentary,5.1,2010-10-15,400000,433588,433588,867176,467176,2010,October,10,Fall,Q4
1762,tt1945044,exeter,91,"Horror,Mystery,Thriller",4.5,2015-09-01,25000,0,489792,489792,464792,2015,September,9,Fall,Q3
1559,tt1801552,gotti,112,"Biography,Crime,Drama",4.8,2018-06-15,10000000,4286367,6089100,10375467,375467,2018,June,6,summer,Q2
1118,tt1594562,theinnkeepers,101,"Drama,Horror,Mystery",5.5,2012-02-03,750000,78396,1011535,1089931,339931,2012,February,2,winter/holiday,Q1
3175,tt7545524,benisback,103,Drama,6.7,2018-12-07,13000000,3703182,9633111,13336293,336293,2018,December,12,winter/holiday,Q4
1164,tt1612774,rubber,82,"Comedy,Fantasy,Horror",5.8,2011-04-01,500000,100370,680914,781284,281284,2011,April,4,spring,Q2
2295,tt2359024,blueruin,90,"Crime,Drama,Thriller",7.1,2014-04-25,420000,258384,437002,695386,275386,2014,April,4,spring,Q2
387,tt1211890,middleofnowhere,97,Drama,6.4,2012-10-12,200000,236806,236806,473612,273612,2012,October,10,Fall,Q4
2938,tt4266638,krisha,83,Drama,7.2,2016-03-18,30000,144822,144822,289644,259644,2016,March,3,spring,Q1
2201,tt2265398,drinkingbuddies,90,"Comedy,Drama,Romance",6.1,2013-08-23,500000,343706,407100,750806,250806,2013,August,8,summer,Q3
2855,tt3835080,31,102,"Horror,Thriller",5.1,2016-10-21,1500000,779820,922727,1702547,202547,2016,October,10,Fall,Q4
2541,tt2884206,iorigins,106,"Drama,Romance,Sci-Fi",7.4,2014-07-18,1000000,336472,852399,1188871,188871,2014,July,7,summer,Q3
2935,tt4238858,thefits,72,"Drama,Music",6.7,2016-06-03,170000,166425,169242,335667,165667,2016,June,6,summer,Q2
1368,tt1703199,graveencounters,92,Horror,6.1,2011-09-09,2000000,0,2151887,2151887,151887,2011,September,9,Fall,Q3
249,tt1053424,repomen,111,"Action,Crime,Sci-Fi",6.3,2010-03-19,32000000,13942007,18195238,32137245,137245,2010,March,3,spring,Q1
2246,tt2304459,23blast,98,"Drama,Family,Sport",6.5,2014-10-24,1000000,549185,549185,1098370,98370,2014,October,10,Fall,Q4
2304,tt2366608,lostriver,95,"Drama,Fantasy,Mystery",5.8,2015-04-07,2000000,45431,2009644,2055075,55075,2015,April,4,spring,Q2
2334,tt2389182,cheapthrills,88,"Comedy,Crime,Drama",6.7,2014-03-21,100000,59424,59424,118848,18848,2014,March,3,spring,Q1
1707,tt1880418,newlyweds,95,"Comedy,Drama",6.4,2012-01-13,9000,4584,4584,9168,168,2012,January,1,winter/holiday,Q1
